Data operacji,Opis,Kwota transakcji,Saldo po operacji
2015-01-02,PRZELEW UZNANIOWY (NADANO 02-01-2015) SK£ADKA CZ£ONKOWSKA ZA MIESI¥C 01-2015  BARTUŒ TESTOWSKI  WOJSKA CZESKIEGO 43 BRNO 74962478794000264223261662,128,1872.00
2015-01-04,PRZELEW UZNANIOWY (NADANO 04-01-2015) SK£ADKA CZ£ONKOWSKA ZA MIESI¥C 01-2015  MAREK NOWAK  WOJSKA CZESKIEGO 43 BRNO 30400151712280809598678381,64,1808.00
2015-01-06,PRZELEW UZNANIOWY (NADANO 06-01-2015) SK£ADKA CZ£ONKOWSKA ZA MIESI¥C 01-2015  MAREK CZARNOWSKI  WOJSKA CZESKIEGO 43 BRNO 68616458961064147545488930,64,1744.00
2015-01-06,PRZELEW UZNANIOWY (NADANO 06-01-2015) SK£ADKA CZ£ONKOWSKA ZA MIESI¥C 01-2015  BARTUŒ TESTOWSKI  WOJSKA CZESKIEGO 43 BRNO 79508411342526316937264643,16,1728.00
2015-01-07,PRZELEW UZNANIOWY (NADANO 07-01-2015) SK£ADKA CZ£ONKOWSKA ZA MIESI¥C 01-2015  PAWE£ NOWAK  WOJSKA CZESKIEGO 43 BRNO 45432364350784968754811291,64,1664.00
2015-01-08,PRZELEW OBCI¥¯ENIOWY (NADANO 08-01-2015) COS DO PLACENIA  LOKAL  WOJSKA CZESKIEGO 43 BRNO 75017166089478830434959736,-341,2005.00
2015-01-10,PRZELEW UZNANIOWY (NADANO 10-01-2015) SK£ADKA CZ£ONKOWSKA ZA MIESI¥C 01-2015  £UKASZ NOWAK  WOJSKA CZESKIEGO 43 BRNO 53861458099487078814562830,64,1941.00
2015-01-12,PRZELEW OBCI¥¯ENIOWY (NADANO 12-01-2015) COS DO PLACENIA  TAURON  WOJSKA CZESKIEGO 43 BRNO 28571387840482785185599598,-669,2610.00
2015-01-14,PRZELEW UZNANIOWY (NADANO 14-01-2015) SK£ADKA CZ£ONKOWSKA ZA MIESI¥C 01-2015  HENRYK CHOLERAWIECKI  WOJSKA CZESKIEGO 43 BRNO 42332833152649376208665580,16,2594.00
2015-01-14,PRZELEW UZNANIOWY (NADANO 14-01-2015) SK£ADKA CZ£ONKOWSKA ZA MIESI¥C 01-2015  STANIS£AW CZARNOWSKI  WOJSKA CZESKIEGO 43 BRNO 46221579105823282728287457,32,2562.00
2015-01-14,PRZELEW UZNANIOWY (NADANO 14-01-2015) SK£ADKA CZ£ONKOWSKA ZA MIESI¥C 01-2015  OKTAWIAN PROSTACKI  WOJSKA CZESKIEGO 43 BRNO 60385269960718034858497664,32,2530.00
2015-01-14,PRZELEW UZNANIOWY (NADANO 14-01-2015) SK£ADKA CZ£ONKOWSKA ZA MIESI¥C 01-2015  STANIS£AW CZARNOWSKI  WOJSKA CZESKIEGO 43 BRNO 33736726083936869283685568,32,2498.00
2015-01-14,PRZELEW UZNANIOWY (NADANO 14-01-2015) SK£ADKA CZ£ONKOWSKA ZA MIESI¥C 01-2015  MAREK STAROWSKI  WOJSKA CZESKIEGO 43 BRNO 93265818915671465680396133,64,2434.00
2015-01-15,PRZELEW OBCI¥¯ENIOWY (NADANO 15-01-2015) COS DO PLACENIA  LOKAL  WOJSKA CZESKIEGO 43 BRNO 53173866518323457535083672,-952,3386.00
2015-01-15,PRZELEW UZNANIOWY (NADANO 15-01-2015) SK£ADKA CZ£ONKOWSKA ZA MIESI¥C 01-2015  STANIS£AW MARKOWSKI  WOJSKA CZESKIEGO 43 BRNO 98654860485672413027163141,128,3258.00
2015-01-16,PRZELEW UZNANIOWY (NADANO 16-01-2015) SK£ADKA CZ£ONKOWSKA ZA MIESI¥C 01-2015  MAREK CZARNOWSKI  WOJSKA CZESKIEGO 43 BRNO 55846127026747046298468515,128,3130.00
2015-01-17,PRZELEW UZNANIOWY (NADANO 17-01-2015) SK£ADKA CZ£ONKOWSKA ZA MIESI¥C 01-2015  DAWID RYBSKI  WOJSKA CZESKIEGO 43 BRNO 11139537975769841784552943,16,3114.00
2015-01-17,PRZELEW UZNANIOWY (NADANO 17-01-2015) SK£ADKA CZ£ONKOWSKA ZA MIESI¥C 01-2015  £UKASZ STAROWSKI  WOJSKA CZESKIEGO 43 BRNO 05001251858112667479444265,128,2986.00
2015-01-18,PRZELEW UZNANIOWY (NADANO 18-01-2015) SK£ADKA CZ£ONKOWSKA ZA MIESI¥C 01-2015  STANIS£AW OWCZAREK  WOJSKA CZESKIEGO 43 BRNO 69149432883626974140369113,64,2922.00
2015-01-20,PRZELEW OBCI¥¯ENIOWY (NADANO 20-01-2015) COS DO PLACENIA  LOKAL  WOJSKA CZESKIEGO 43 BRNO 12128059635043085408276040,-476,3398.00
2015-01-22,PRZELEW UZNANIOWY (NADANO 22-01-2015) SK£ADKA CZ£ONKOWSKA ZA MIESI¥C 01-2015  STANIS£AW WARSZAWSKI  WOJSKA CZESKIEGO 43 BRNO 27643769581031022706885264,32,3366.00
2015-01-22,PRZELEW UZNANIOWY (NADANO 22-01-2015) SK£ADKA CZ£ONKOWSKA ZA MIESI¥C 01-2015  OKTAWIAN RYBSKI  WOJSKA CZESKIEGO 43 BRNO 68195784522531269437513301,64,3302.00
2015-01-22,PRZELEW UZNANIOWY (NADANO 22-01-2015) SK£ADKA CZ£ONKOWSKA ZA MIESI¥C 01-2015  PAWE£ NOWAK  WOJSKA CZESKIEGO 43 BRNO 74556566511352677103179412,64,3238.00
2015-01-24,PRZELEW UZNANIOWY (NADANO 24-01-2015) DAROWIZNA  DAWID MARKOWSKI  WOJSKA CZESKIEGO 43 BRNO 20939336532289237433267487,797,2441.00
2015-01-25,PRZELEW UZNANIOWY (NADANO 25-01-2015) SK£ADKA CZ£ONKOWSKA ZA MIESI¥C 01-2015  MAREK OWCZAREK  WOJSKA CZESKIEGO 43 BRNO 76277755546656019662844628,128,2313.00
2015-01-25,PRZELEW UZNANIOWY (NADANO 25-01-2015) SK£ADKA CZ£ONKOWSKA ZA MIESI¥C 01-2015  STANIS£AW STAROWSKI  WOJSKA CZESKIEGO 43 BRNO 11804464664353830251033335,128,2185.00
2015-01-26,PRZELEW UZNANIOWY (NADANO 26-01-2015) SK£ADKA CZ£ONKOWSKA ZA MIESI¥C 01-2015  OKTAWIAN RYBSKI  WOJSKA CZESKIEGO 43 BRNO 21861889008630314533200996,32,2153.00
2015-01-27,PRZELEW OBCI¥¯ENIOWY (NADANO 27-01-2015) COS DO PLACENIA  TAURON  WOJSKA CZESKIEGO 43 BRNO 03082753517049259363868175,-454,2607.00
2015-01-27,PRZELEW OBCI¥¯ENIOWY (NADANO 27-01-2015) COS DO PLACENIA  LOKAL  WOJSKA CZESKIEGO 43 BRNO 25607166700892136608535797,-578,3185.00
2015-01-27,PRZELEW UZNANIOWY (NADANO 27-01-2015) SK£ADKA CZ£ONKOWSKA ZA MIESI¥C 01-2015  MICHA£ WARSZAWSKI  WOJSKA CZESKIEGO 43 BRNO 68377479839981399900745651,32,3153.00
2015-01-27,PRZELEW OBCI¥¯ENIOWY (NADANO 27-01-2015) COS DO PLACENIA  TAURON  WOJSKA CZESKIEGO 43 BRNO 56885225062176610438757427,-603,3756.00
2015-01-27,PRZELEW UZNANIOWY (NADANO 27-01-2015) SK£ADKA CZ£ONKOWSKA ZA MIESI¥C 01-2015  BARTUŒ NOWAK  WOJSKA CZESKIEGO 43 BRNO 45848550185064670454413652,32,3724.00
2015-01-27,PRZELEW OBCI¥¯ENIOWY (NADANO 27-01-2015) COS DO PLACENIA  UPC  WOJSKA CZESKIEGO 43 BRNO 53255639841763546081817311,-825,4549.00
2015-01-27,PRZELEW UZNANIOWY (NADANO 27-01-2015) SK£ADKA CZ£ONKOWSKA ZA MIESI¥C 01-2015  OKTAWIAN RYBSKI  WOJSKA CZESKIEGO 43 BRNO 49614355494318721186165121,32,4517.00
2015-01-27,PRZELEW UZNANIOWY (NADANO 27-01-2015) SK£ADKA CZ£ONKOWSKA ZA MIESI¥C 01-2015  BARTUŒ TESTOWSKI  WOJSKA CZESKIEGO 43 BRNO 91383707225108705816458263,16,4501.00
2015-01-27,PRZELEW UZNANIOWY (NADANO 27-01-2015) SK£ADKA CZ£ONKOWSKA ZA MIESI¥C 01-2015  £UKASZ NOWAK  WOJSKA CZESKIEGO 43 BRNO 82949072157377951345417176,32,4469.00
2015-01-28,PRZELEW UZNANIOWY (NADANO 28-01-2015) SK£ADKA CZ£ONKOWSKA ZA MIESI¥C 01-2015  DAWID NOWAK  WOJSKA CZESKIEGO 43 BRNO 36237890868191093878382465,128,4341.00
2015-01-29,PRZELEW UZNANIOWY (NADANO 29-01-2015) SK£ADKA CZ£ONKOWSKA ZA MIESI¥C 01-2015  MICHA£ WARSZAWSKI  WOJSKA CZESKIEGO 43 BRNO 40975218652739486297540791,64,4277.00
2015-01-30,PRZELEW UZNANIOWY (NADANO 30-01-2015) SK£ADKA CZ£ONKOWSKA ZA MIESI¥C 01-2015  STANIS£AW CZARNOWSKI  WOJSKA CZESKIEGO 43 BRNO 29764054930714297237273945,128,4149.00
2015-01-30,PRZELEW UZNANIOWY (NADANO 30-01-2015) SK£ADKA CZ£ONKOWSKA ZA MIESI¥C 01-2015  PAWE£ KOWALSKI  WOJSKA CZESKIEGO 43 BRNO 70767207794087724523506554,16,4133.00
2015-01-30,PRZELEW UZNANIOWY (NADANO 30-01-2015) SK£ADKA CZ£ONKOWSKA ZA MIESI¥C 01-2015  MICHA£ CZARNOWSKI  WOJSKA CZESKIEGO 43 BRNO 06669322915359954266702247,16,4117.00
2015-01-31,PRZELEW UZNANIOWY (NADANO 31-01-2015) SK£ADKA CZ£ONKOWSKA ZA MIESI¥C 01-2015  MAREK CZARNOWSKI  WOJSKA CZESKIEGO 43 BRNO 65769442693090899866994911,128,3989.00
2015-01-31,PRZELEW UZNANIOWY (NADANO 31-01-2015) SK£ADKA CZ£ONKOWSKA ZA MIESI¥C 01-2015  PAWE£ NOWAK  WOJSKA CZESKIEGO 43 BRNO 08165713936407644119202021,128,3861.00
2015-02-01,PRZELEW UZNANIOWY (NADANO 01-02-2015) SK£ADKA CZ£ONKOWSKA ZA MIESI¥C 02-2015  MAREK CZARNOWSKI  WOJSKA CZESKIEGO 43 BRNO 32509661896796270397581879,64,3797.00
2015-02-02,PRZELEW UZNANIOWY (NADANO 02-02-2015) SK£ADKA CZ£ONKOWSKA ZA MIESI¥C 02-2015  DAWID MARKOWSKI  WOJSKA CZESKIEGO 43 BRNO 13506551117950285046373434,128,3669.00
2015-02-03,PRZELEW UZNANIOWY (NADANO 03-02-2015) SK£ADKA CZ£ONKOWSKA ZA MIESI¥C 02-2015  MAREK NOWAK  WOJSKA CZESKIEGO 43 BRNO 31754961020161315819910179,16,3653.00
2015-02-04,PRZELEW OBCI¥¯ENIOWY (NADANO 04-02-2015) COS DO PLACENIA  UPC  WOJSKA CZESKIEGO 43 BRNO 01138520619179435026197937,-623,4276.00
2015-02-04,PRZELEW OBCI¥¯ENIOWY (NADANO 04-02-2015) COS DO PLACENIA  TAURON  WOJSKA CZESKIEGO 43 BRNO 25184234556202300926691943,-426,4702.00
2015-02-06,PRZELEW OBCI¥¯ENIOWY (NADANO 06-02-2015) COS DO PLACENIA  UPC  WOJSKA CZESKIEGO 43 BRNO 72815381180738201720388264,-373,5075.00
2015-02-06,PRZELEW UZNANIOWY (NADANO 06-02-2015) SK£ADKA CZ£ONKOWSKA ZA MIESI¥C 02-2015  HENRYK CHOLERAWIECKI  WOJSKA CZESKIEGO 43 BRNO 90136284217560055799742133,64,5011.00
2015-02-07,PRZELEW UZNANIOWY (NADANO 07-02-2015) SK£ADKA CZ£ONKOWSKA ZA MIESI¥C 02-2015  HENRYK KOWALSKI  WOJSKA CZESKIEGO 43 BRNO 00816307852684960295587157,16,4995.00
2015-02-09,PRZELEW UZNANIOWY (NADANO 09-02-2015) SK£ADKA CZ£ONKOWSKA ZA MIESI¥C 02-2015  STANIS£AW WARSZAWSKI  WOJSKA CZESKIEGO 43 BRNO 21422767594561887203070115,32,4963.00
2015-02-09,PRZELEW UZNANIOWY (NADANO 09-02-2015) SK£ADKA CZ£ONKOWSKA ZA MIESI¥C 02-2015  OKTAWIAN NOWAK  WOJSKA CZESKIEGO 43 BRNO 94517625571068081239101923,16,4947.00
2015-02-10,PRZELEW UZNANIOWY (NADANO 10-02-2015) SK£ADKA CZ£ONKOWSKA ZA MIESI¥C 02-2015  MICHA£ KOWALSKI  WOJSKA CZESKIEGO 43 BRNO 58357704398636482355571933,16,4931.00
2015-02-11,PRZELEW UZNANIOWY (NADANO 11-02-2015) SK£ADKA CZ£ONKOWSKA ZA MIESI¥C 02-2015  MICHA£ KOWALSKI  WOJSKA CZESKIEGO 43 BRNO 59700466134462914701706331,64,4867.00
2015-02-12,PRZELEW UZNANIOWY (NADANO 12-02-2015) SK£ADKA CZ£ONKOWSKA ZA MIESI¥C 02-2015  HENRYK CHOLERAWIECKI  WOJSKA CZESKIEGO 43 BRNO 70795481369867816147239794,32,4835.00
2015-02-13,PRZELEW UZNANIOWY (NADANO 13-02-2015) SK£ADKA CZ£ONKOWSKA ZA MIESI¥C 02-2015  BARTUŒ TESTOWSKI  WOJSKA CZESKIEGO 43 BRNO 81951121200396890958526395,64,4771.00
2015-02-14,PRZELEW UZNANIOWY (NADANO 14-02-2015) SK£ADKA CZ£ONKOWSKA ZA MIESI¥C 02-2015  HENRYK CHOLERAWIECKI  WOJSKA CZESKIEGO 43 BRNO 46406782406762648829089262,16,4755.00
2015-02-14,PRZELEW UZNANIOWY (NADANO 14-02-2015) SK£ADKA CZ£ONKOWSKA ZA MIESI¥C 02-2015  OKTAWIAN RYBSKI  WOJSKA CZESKIEGO 43 BRNO 94066443115595815725402164,128,4627.00
2015-02-15,PRZELEW UZNANIOWY (NADANO 15-02-2015) SK£ADKA CZ£ONKOWSKA ZA MIESI¥C 02-2015  BARTUŒ CZARNOWSKI  WOJSKA CZESKIEGO 43 BRNO 14984172989291456289787709,128,4499.00
2015-02-15,PRZELEW UZNANIOWY (NADANO 15-02-2015) SK£ADKA CZ£ONKOWSKA ZA MIESI¥C 02-2015  MAREK OWCZAREK  WOJSKA CZESKIEGO 43 BRNO 03957827207746413767472596,64,4435.00
2015-02-17,PRZELEW UZNANIOWY (NADANO 17-02-2015) SK£ADKA CZ£ONKOWSKA ZA MIESI¥C 02-2015  MAREK NOWAK  WOJSKA CZESKIEGO 43 BRNO 45665035642911715230384133,64,4371.00
2015-02-18,PRZELEW UZNANIOWY (NADANO 18-02-2015) DAROWIZNA  MAREK OWCZAREK  WOJSKA CZESKIEGO 43 BRNO 01088426976069019907408218,434,3937.00
2015-02-20,PRZELEW UZNANIOWY (NADANO 20-02-2015) SK£ADKA CZ£ONKOWSKA ZA MIESI¥C 02-2015  MICHA£ KOWALSKI  WOJSKA CZESKIEGO 43 BRNO 12943341242135288821293547,64,3873.00
2015-02-21,PRZELEW UZNANIOWY (NADANO 21-02-2015) SK£ADKA CZ£ONKOWSKA ZA MIESI¥C 02-2015  DAWID RYBSKI  WOJSKA CZESKIEGO 43 BRNO 87854361131890513152033188,32,3841.00
2015-02-23,PRZELEW UZNANIOWY (NADANO 23-02-2015) SK£ADKA CZ£ONKOWSKA ZA MIESI¥C 02-2015  MICHA£ WARSZAWSKI  WOJSKA CZESKIEGO 43 BRNO 79469264292690589758654303,16,3825.00
2015-02-24,PRZELEW UZNANIOWY (NADANO 24-02-2015) SK£ADKA CZ£ONKOWSKA ZA MIESI¥C 02-2015  OKTAWIAN RYBSKI  WOJSKA CZESKIEGO 43 BRNO 75781275767885452059120113,32,3793.00
2015-02-24,PRZELEW UZNANIOWY (NADANO 24-02-2015) SK£ADKA CZ£ONKOWSKA ZA MIESI¥C 02-2015  £UKASZ WARSZAWSKI  WOJSKA CZESKIEGO 43 BRNO 00508385333262106773113026,16,3777.00
2015-02-25,PRZELEW UZNANIOWY (NADANO 25-02-2015) SK£ADKA CZ£ONKOWSKA ZA MIESI¥C 02-2015  STANIS£AW CZARNOWSKI  WOJSKA CZESKIEGO 43 BRNO 05152374203607055437424852,32,3745.00
2015-02-27,PRZELEW OBCI¥¯ENIOWY (NADANO 27-02-2015) COS DO PLACENIA  LOKAL  WOJSKA CZESKIEGO 43 BRNO 55200026016826344311481591,-268,4013.00
2015-02-28,PRZELEW UZNANIOWY (NADANO 28-02-2015) DAROWIZNA  £UKASZ NOWAK  WOJSKA CZESKIEGO 43 BRNO 76498169632126764469545146,798,3215.00
2015-02-28,PRZELEW OBCI¥¯ENIOWY (NADANO 28-02-2015) COS DO PLACENIA  LOKAL  WOJSKA CZESKIEGO 43 BRNO 64577759591053677875118642,-810,4025.00
2015-03-01,PRZELEW UZNANIOWY (NADANO 01-03-2015) SK£ADKA CZ£ONKOWSKA ZA MIESI¥C 03-2015  PAWE£ KOWALSKI  WOJSKA CZESKIEGO 43 BRNO 28782511053127163497241831,16,4009.00
2015-03-02,PRZELEW UZNANIOWY (NADANO 02-03-2015) SK£ADKA CZ£ONKOWSKA ZA MIESI¥C 03-2015  PAWE£ NOWAK  WOJSKA CZESKIEGO 43 BRNO 26207508599574402846081479,128,3881.00
2015-03-02,PRZELEW UZNANIOWY (NADANO 02-03-2015) SK£ADKA CZ£ONKOWSKA ZA MIESI¥C 03-2015  £UKASZ NOWAK  WOJSKA CZESKIEGO 43 BRNO 93459732484908774973921170,32,3849.00
2015-03-04,PRZELEW UZNANIOWY (NADANO 04-03-2015) SK£ADKA CZ£ONKOWSKA ZA MIESI¥C 03-2015  STANIS£AW MARKOWSKI  WOJSKA CZESKIEGO 43 BRNO 53949973201426885855107685,16,3833.00
2015-03-04,PRZELEW UZNANIOWY (NADANO 04-03-2015) SK£ADKA CZ£ONKOWSKA ZA MIESI¥C 03-2015  BARTUŒ NOWAK  WOJSKA CZESKIEGO 43 BRNO 69155813216924186312402178,64,3769.00
2015-03-06,PRZELEW UZNANIOWY (NADANO 06-03-2015) SK£ADKA CZ£ONKOWSKA ZA MIESI¥C 03-2015  DAWID MARKOWSKI  WOJSKA CZESKIEGO 43 BRNO 31672206125428316659425532,32,3737.00
2015-03-07,PRZELEW UZNANIOWY (NADANO 07-03-2015) SK£ADKA CZ£ONKOWSKA ZA MIESI¥C 03-2015  OKTAWIAN RYBSKI  WOJSKA CZESKIEGO 43 BRNO 74538058641684781985668066,64,3673.00
2015-03-08,PRZELEW UZNANIOWY (NADANO 08-03-2015) SK£ADKA CZ£ONKOWSKA ZA MIESI¥C 03-2015  OKTAWIAN PROSTACKI  WOJSKA CZESKIEGO 43 BRNO 64622363628346838176727427,64,3609.00
2015-03-10,PRZELEW UZNANIOWY (NADANO 10-03-2015) SK£ADKA CZ£ONKOWSKA ZA MIESI¥C 03-2015  STANIS£AW WARSZAWSKI  WOJSKA CZESKIEGO 43 BRNO 53404680590132882042854019,128,3481.00
2015-03-12,PRZELEW UZNANIOWY (NADANO 12-03-2015) SK£ADKA CZ£ONKOWSKA ZA MIESI¥C 03-2015  OKTAWIAN RYBSKI  WOJSKA CZESKIEGO 43 BRNO 83021114436893412810547451,64,3417.00
2015-03-13,PRZELEW OBCI¥¯ENIOWY (NADANO 13-03-2015) COS DO PLACENIA  TAURON  WOJSKA CZESKIEGO 43 BRNO 40958725848181702279919847,-627,4044.00
2015-03-14,PRZELEW UZNANIOWY (NADANO 14-03-2015) SK£ADKA CZ£ONKOWSKA ZA MIESI¥C 03-2015  £UKASZ STAROWSKI  WOJSKA CZESKIEGO 43 BRNO 79017620861869435611705425,64,3980.00
2015-03-14,PRZELEW UZNANIOWY (NADANO 14-03-2015) SK£ADKA CZ£ONKOWSKA ZA MIESI¥C 03-2015  DAWID NOWAK  WOJSKA CZESKIEGO 43 BRNO 88469235057740578867933118,64,3916.00
2015-03-15,PRZELEW UZNANIOWY (NADANO 15-03-2015) SK£ADKA CZ£ONKOWSKA ZA MIESI¥C 03-2015  DAREK NOWAK  WOJSKA CZESKIEGO 43 BRNO 74548552366597125122262507,64,3852.00
2015-03-15,PRZELEW UZNANIOWY (NADANO 15-03-2015) DAROWIZNA  MICHA£ CZARNOWSKI  WOJSKA CZESKIEGO 43 BRNO 52369248262637968446560188,298,3554.00
2015-03-16,PRZELEW UZNANIOWY (NADANO 16-03-2015) DAROWIZNA  MAREK NOWAK  WOJSKA CZESKIEGO 43 BRNO 28686312797488495053291808,678,2876.00
2015-03-18,PRZELEW UZNANIOWY (NADANO 18-03-2015) SK£ADKA CZ£ONKOWSKA ZA MIESI¥C 03-2015  OKTAWIAN PROSTACKI  WOJSKA CZESKIEGO 43 BRNO 56437069045307258294751725,16,2860.00
2015-03-20,PRZELEW UZNANIOWY (NADANO 20-03-2015) SK£ADKA CZ£ONKOWSKA ZA MIESI¥C 03-2015  STANIS£AW MARKOWSKI  WOJSKA CZESKIEGO 43 BRNO 67494524226837596226170432,64,2796.00
2015-03-22,PRZELEW OBCI¥¯ENIOWY (NADANO 22-03-2015) COS DO PLACENIA  UPC  WOJSKA CZESKIEGO 43 BRNO 58484158412991844672296611,-913,3709.00
2015-03-24,PRZELEW UZNANIOWY (NADANO 24-03-2015) SK£ADKA CZ£ONKOWSKA ZA MIESI¥C 03-2015  MICHA£ KOWALSKI  WOJSKA CZESKIEGO 43 BRNO 78066477518931257640213598,128,3581.00
2015-03-26,PRZELEW UZNANIOWY (NADANO 26-03-2015) SK£ADKA CZ£ONKOWSKA ZA MIESI¥C 03-2015  £UKASZ NOWAK  WOJSKA CZESKIEGO 43 BRNO 55332281443450090680107031,32,3549.00
2015-03-27,PRZELEW UZNANIOWY (NADANO 27-03-2015) SK£ADKA CZ£ONKOWSKA ZA MIESI¥C 03-2015  DAREK NOWAK  WOJSKA CZESKIEGO 43 BRNO 05761869608791765454889093,128,3421.00
2015-03-27,PRZELEW UZNANIOWY (NADANO 27-03-2015) SK£ADKA CZ£ONKOWSKA ZA MIESI¥C 03-2015  BARTUŒ CZARNOWSKI  WOJSKA CZESKIEGO 43 BRNO 12788407653705877523629677,128,3293.00
2015-03-28,PRZELEW UZNANIOWY (NADANO 28-03-2015) SK£ADKA CZ£ONKOWSKA ZA MIESI¥C 03-2015  STANIS£AW OWCZAREK  WOJSKA CZESKIEGO 43 BRNO 74350168180824882667763289,16,3277.00
2015-03-29,PRZELEW UZNANIOWY (NADANO 29-03-2015) SK£ADKA CZ£ONKOWSKA ZA MIESI¥C 03-2015  OKTAWIAN NOWAK  WOJSKA CZESKIEGO 43 BRNO 87118549359631871851217380,64,3213.00
2015-03-30,PRZELEW OBCI¥¯ENIOWY (NADANO 30-03-2015) COS DO PLACENIA  TAURON  WOJSKA CZESKIEGO 43 BRNO 72751162927640414338193281,-963,4176.00
2015-03-31,PRZELEW UZNANIOWY (NADANO 31-03-2015) SK£ADKA CZ£ONKOWSKA ZA MIESI¥C 03-2015  STANIS£AW CZARNOWSKI  WOJSKA CZESKIEGO 43 BRNO 77076045571337873082417550,128,4048.00
2015-04-02,PRZELEW UZNANIOWY (NADANO 02-04-2015) SK£ADKA CZ£ONKOWSKA ZA MIESI¥C 04-2015  £UKASZ STAROWSKI  WOJSKA CZESKIEGO 43 BRNO 76046176153952994693611002,64,3984.00
2015-04-02,PRZELEW UZNANIOWY (NADANO 02-04-2015) SK£ADKA CZ£ONKOWSKA ZA MIESI¥C 04-2015  STANIS£AW CZARNOWSKI  WOJSKA CZESKIEGO 43 BRNO 85561918395994142178742156,64,3920.00
2015-04-02,PRZELEW UZNANIOWY (NADANO 02-04-2015) SK£ADKA CZ£ONKOWSKA ZA MIESI¥C 04-2015  MICHA£ CZARNOWSKI  WOJSKA CZESKIEGO 43 BRNO 71932777403045137928529067,16,3904.00
2015-04-03,PRZELEW UZNANIOWY (NADANO 03-04-2015) SK£ADKA CZ£ONKOWSKA ZA MIESI¥C 04-2015  MAREK STAROWSKI  WOJSKA CZESKIEGO 43 BRNO 65872367661263798527247795,64,3840.00
2015-04-05,PRZELEW UZNANIOWY (NADANO 05-04-2015) SK£ADKA CZ£ONKOWSKA ZA MIESI¥C 04-2015  OKTAWIAN RYBSKI  WOJSKA CZESKIEGO 43 BRNO 73851922074338721332149926,128,3712.00
2015-04-05,PRZELEW UZNANIOWY (NADANO 05-04-2015) SK£ADKA CZ£ONKOWSKA ZA MIESI¥C 04-2015  HENRYK CHOLERAWIECKI  WOJSKA CZESKIEGO 43 BRNO 62769054583333809843784633,128,3584.00
2015-04-06,PRZELEW OBCI¥¯ENIOWY (NADANO 06-04-2015) COS DO PLACENIA  LOKAL  WOJSKA CZESKIEGO 43 BRNO 93862462578803727079899186,-400,3984.00
2015-04-07,PRZELEW UZNANIOWY (NADANO 07-04-2015) SK£ADKA CZ£ONKOWSKA ZA MIESI¥C 04-2015  DAWID MARKOWSKI  WOJSKA CZESKIEGO 43 BRNO 62659446380161715404612218,128,3856.00
2015-04-08,PRZELEW OBCI¥¯ENIOWY (NADANO 08-04-2015) COS DO PLACENIA  TAURON  WOJSKA CZESKIEGO 43 BRNO 35047931461199974189547724,-314,4170.00
2015-04-10,PRZELEW UZNANIOWY (NADANO 10-04-2015) DAROWIZNA  MICHA£ CZARNOWSKI  WOJSKA CZESKIEGO 43 BRNO 72021489119727476350383027,383,3787.00
2015-04-11,PRZELEW UZNANIOWY (NADANO 11-04-2015) SK£ADKA CZ£ONKOWSKA ZA MIESI¥C 04-2015  £UKASZ WARSZAWSKI  WOJSKA CZESKIEGO 43 BRNO 56142034515708465811982111,64,3723.00
2015-04-13,PRZELEW UZNANIOWY (NADANO 13-04-2015) SK£ADKA CZ£ONKOWSKA ZA MIESI¥C 04-2015  HENRYK KOWALSKI  WOJSKA CZESKIEGO 43 BRNO 22417929446495892847948317,32,3691.00
2015-04-15,PRZELEW UZNANIOWY (NADANO 15-04-2015) SK£ADKA CZ£ONKOWSKA ZA MIESI¥C 04-2015  HENRYK CHOLERAWIECKI  WOJSKA CZESKIEGO 43 BRNO 89817238515808347262361657,16,3675.00
2015-04-16,PRZELEW OBCI¥¯ENIOWY (NADANO 16-04-2015) COS DO PLACENIA  LOKAL  WOJSKA CZESKIEGO 43 BRNO 95998286143485060726920633,-583,4258.00
2015-04-18,PRZELEW UZNANIOWY (NADANO 18-04-2015) SK£ADKA CZ£ONKOWSKA ZA MIESI¥C 04-2015  BARTUŒ NOWAK  WOJSKA CZESKIEGO 43 BRNO 50446350358810451520053258,64,4194.00
2015-04-18,PRZELEW UZNANIOWY (NADANO 18-04-2015) SK£ADKA CZ£ONKOWSKA ZA MIESI¥C 04-2015  £UKASZ WARSZAWSKI  WOJSKA CZESKIEGO 43 BRNO 34364396887866916027067700,32,4162.00
2015-04-19,PRZELEW UZNANIOWY (NADANO 19-04-2015) SK£ADKA CZ£ONKOWSKA ZA MIESI¥C 04-2015  DAWID RYBSKI  WOJSKA CZESKIEGO 43 BRNO 60387729977985459054978568,32,4130.00
2015-04-20,PRZELEW UZNANIOWY (NADANO 20-04-2015) SK£ADKA CZ£ONKOWSKA ZA MIESI¥C 04-2015  BARTUŒ NOWAK  WOJSKA CZESKIEGO 43 BRNO 71231335389858335707499674,16,4114.00
2015-04-20,PRZELEW UZNANIOWY (NADANO 20-04-2015) SK£ADKA CZ£ONKOWSKA ZA MIESI¥C 04-2015  HENRYK CHOLERAWIECKI  WOJSKA CZESKIEGO 43 BRNO 18084039785440376864182474,32,4082.00
2015-04-21,PRZELEW UZNANIOWY (NADANO 21-04-2015) SK£ADKA CZ£ONKOWSKA ZA MIESI¥C 04-2015  MAREK STAROWSKI  WOJSKA CZESKIEGO 43 BRNO 65568992628576198567897813,32,4050.00
2015-04-23,PRZELEW UZNANIOWY (NADANO 23-04-2015) SK£ADKA CZ£ONKOWSKA ZA MIESI¥C 04-2015  £UKASZ WARSZAWSKI  WOJSKA CZESKIEGO 43 BRNO 43679760227352604715352537,32,4018.00
2015-04-25,PRZELEW UZNANIOWY (NADANO 25-04-2015) SK£ADKA CZ£ONKOWSKA ZA MIESI¥C 04-2015  £UKASZ WARSZAWSKI  WOJSKA CZESKIEGO 43 BRNO 30677330261047772618444369,64,3954.00
2015-04-26,PRZELEW UZNANIOWY (NADANO 26-04-2015) SK£ADKA CZ£ONKOWSKA ZA MIESI¥C 04-2015  MAREK TESTOWSKI  WOJSKA CZESKIEGO 43 BRNO 53031109026271122948939875,32,3922.00
2015-04-28,PRZELEW UZNANIOWY (NADANO 28-04-2015) SK£ADKA CZ£ONKOWSKA ZA MIESI¥C 04-2015  OKTAWIAN PROSTACKI  WOJSKA CZESKIEGO 43 BRNO 21790479225122387470005393,128,3794.00
2015-04-29,PRZELEW UZNANIOWY (NADANO 29-04-2015) SK£ADKA CZ£ONKOWSKA ZA MIESI¥C 04-2015  MICHA£ KOWALSKI  WOJSKA CZESKIEGO 43 BRNO 93376977485962912781588434,32,3762.00
2015-05-01,PRZELEW OBCI¥¯ENIOWY (NADANO 01-05-2015) COS DO PLACENIA  LOKAL  WOJSKA CZESKIEGO 43 BRNO 13257366427264700901133386,-313,4075.00
2015-05-03,PRZELEW UZNANIOWY (NADANO 03-05-2015) SK£ADKA CZ£ONKOWSKA ZA MIESI¥C 05-2015  BARTUŒ NOWAK  WOJSKA CZESKIEGO 43 BRNO 14409502232072179661164279,128,3947.00
2015-05-05,PRZELEW UZNANIOWY (NADANO 05-05-2015) SK£ADKA CZ£ONKOWSKA ZA MIESI¥C 05-2015  MICHA£ KOWALSKI  WOJSKA CZESKIEGO 43 BRNO 96250532677584611674173216,32,3915.00
2015-05-07,PRZELEW UZNANIOWY (NADANO 07-05-2015) SK£ADKA CZ£ONKOWSKA ZA MIESI¥C 05-2015  HENRYK KOWALSKI  WOJSKA CZESKIEGO 43 BRNO 30399204811967717691208279,32,3883.00
2015-05-07,PRZELEW UZNANIOWY (NADANO 07-05-2015) SK£ADKA CZ£ONKOWSKA ZA MIESI¥C 05-2015  £UKASZ NOWAK  WOJSKA CZESKIEGO 43 BRNO 24931066583395257219947201,16,3867.00
2015-05-08,PRZELEW OBCI¥¯ENIOWY (NADANO 08-05-2015) COS DO PLACENIA  UPC  WOJSKA CZESKIEGO 43 BRNO 14595098959505702412831395,-460,4327.00
2015-05-09,PRZELEW UZNANIOWY (NADANO 09-05-2015) SK£ADKA CZ£ONKOWSKA ZA MIESI¥C 05-2015  MAREK NOWAK  WOJSKA CZESKIEGO 43 BRNO 13602316255367602420942290,16,4311.00
2015-05-09,PRZELEW UZNANIOWY (NADANO 09-05-2015) SK£ADKA CZ£ONKOWSKA ZA MIESI¥C 05-2015  BARTUŒ CZARNOWSKI  WOJSKA CZESKIEGO 43 BRNO 62967097710957578540991787,64,4247.00
2015-05-09,PRZELEW UZNANIOWY (NADANO 09-05-2015) SK£ADKA CZ£ONKOWSKA ZA MIESI¥C 05-2015  STANIS£AW CZARNOWSKI  WOJSKA CZESKIEGO 43 BRNO 48119978565063349183575483,128,4119.00
2015-05-10,PRZELEW UZNANIOWY (NADANO 10-05-2015) SK£ADKA CZ£ONKOWSKA ZA MIESI¥C 05-2015  BARTUŒ TESTOWSKI  WOJSKA CZESKIEGO 43 BRNO 20440803948170600607270159,32,4087.00
2015-05-12,PRZELEW UZNANIOWY (NADANO 12-05-2015) SK£ADKA CZ£ONKOWSKA ZA MIESI¥C 05-2015  MAREK NOWAK  WOJSKA CZESKIEGO 43 BRNO 04180067506042874334708268,16,4071.00
2015-05-14,PRZELEW UZNANIOWY (NADANO 14-05-2015) SK£ADKA CZ£ONKOWSKA ZA MIESI¥C 05-2015  STANIS£AW STAROWSKI  WOJSKA CZESKIEGO 43 BRNO 30488559655967072116098363,128,3943.00
2015-05-16,PRZELEW UZNANIOWY (NADANO 16-05-2015) SK£ADKA CZ£ONKOWSKA ZA MIESI¥C 05-2015  MICHA£ CZARNOWSKI  WOJSKA CZESKIEGO 43 BRNO 82015227815515819076096882,16,3927.00
2015-05-17,PRZELEW UZNANIOWY (NADANO 17-05-2015) SK£ADKA CZ£ONKOWSKA ZA MIESI¥C 05-2015  MAREK OWCZAREK  WOJSKA CZESKIEGO 43 BRNO 87147943645089413568656606,32,3895.00
2015-05-18,PRZELEW UZNANIOWY (NADANO 18-05-2015) SK£ADKA CZ£ONKOWSKA ZA MIESI¥C 05-2015  PAWE£ KOWALSKI  WOJSKA CZESKIEGO 43 BRNO 48599794939136541928655101,64,3831.00
2015-05-18,PRZELEW UZNANIOWY (NADANO 18-05-2015) DAROWIZNA  BARTUŒ NOWAK  WOJSKA CZESKIEGO 43 BRNO 69839294041073654721437216,819,3012.00
2015-05-20,PRZELEW UZNANIOWY (NADANO 20-05-2015) SK£ADKA CZ£ONKOWSKA ZA MIESI¥C 05-2015  MICHA£ WARSZAWSKI  WOJSKA CZESKIEGO 43 BRNO 81891618720957049558622506,16,2996.00
2015-05-22,PRZELEW UZNANIOWY (NADANO 22-05-2015) DAROWIZNA  £UKASZ STAROWSKI  WOJSKA CZESKIEGO 43 BRNO 93698208946160148734111388,719,2277.00
2015-05-23,PRZELEW UZNANIOWY (NADANO 23-05-2015) SK£ADKA CZ£ONKOWSKA ZA MIESI¥C 05-2015  MAREK OWCZAREK  WOJSKA CZESKIEGO 43 BRNO 29715292352629257687440127,64,2213.00
2015-05-23,PRZELEW UZNANIOWY (NADANO 23-05-2015) SK£ADKA CZ£ONKOWSKA ZA MIESI¥C 05-2015  £UKASZ NOWAK  WOJSKA CZESKIEGO 43 BRNO 93697851362111332435941592,32,2181.00
2015-05-25,PRZELEW UZNANIOWY (NADANO 25-05-2015) SK£ADKA CZ£ONKOWSKA ZA MIESI¥C 05-2015  MICHA£ CZARNOWSKI  WOJSKA CZESKIEGO 43 BRNO 42187043042560162682779085,32,2149.00
2015-05-25,PRZELEW UZNANIOWY (NADANO 25-05-2015) SK£ADKA CZ£ONKOWSKA ZA MIESI¥C 05-2015  STANIS£AW CZARNOWSKI  WOJSKA CZESKIEGO 43 BRNO 74502609194087170330368033,32,2117.00
2015-05-25,PRZELEW UZNANIOWY (NADANO 25-05-2015) SK£ADKA CZ£ONKOWSKA ZA MIESI¥C 05-2015  BARTUŒ TESTOWSKI  WOJSKA CZESKIEGO 43 BRNO 45743812852642706612980400,128,1989.00
2015-05-27,PRZELEW UZNANIOWY (NADANO 27-05-2015) SK£ADKA CZ£ONKOWSKA ZA MIESI¥C 05-2015  BARTUŒ TESTOWSKI  WOJSKA CZESKIEGO 43 BRNO 42394900694201739988768592,16,1973.00
2015-05-28,PRZELEW OBCI¥¯ENIOWY (NADANO 28-05-2015) COS DO PLACENIA  TAURON  WOJSKA CZESKIEGO 43 BRNO 55307807488054641901909148,-474,2447.00
2015-05-29,PRZELEW UZNANIOWY (NADANO 29-05-2015) SK£ADKA CZ£ONKOWSKA ZA MIESI¥C 05-2015  DAWID RYBSKI  WOJSKA CZESKIEGO 43 BRNO 45042973922888722829492429,64,2383.00
2015-05-31,PRZELEW UZNANIOWY (NADANO 31-05-2015) SK£ADKA CZ£ONKOWSKA ZA MIESI¥C 05-2015  MICHA£ KOWALSKI  WOJSKA CZESKIEGO 43 BRNO 74310491351025335626361588,16,2367.00
2015-06-02,PRZELEW UZNANIOWY (NADANO 02-06-2015) SK£ADKA CZ£ONKOWSKA ZA MIESI¥C 06-2015  OKTAWIAN NOWAK  WOJSKA CZESKIEGO 43 BRNO 94650090479123039989485001,128,2239.00
2015-06-02,PRZELEW UZNANIOWY (NADANO 02-06-2015) SK£ADKA CZ£ONKOWSKA ZA MIESI¥C 06-2015  STANIS£AW OWCZAREK  WOJSKA CZESKIEGO 43 BRNO 72235471843057081164203536,64,2175.00
2015-06-02,PRZELEW OBCI¥¯ENIOWY (NADANO 02-06-2015) COS DO PLACENIA  UPC  WOJSKA CZESKIEGO 43 BRNO 05575123572470254345807953,-379,2554.00
2015-06-02,PRZELEW UZNANIOWY (NADANO 02-06-2015) SK£ADKA CZ£ONKOWSKA ZA MIESI¥C 06-2015  £UKASZ STAROWSKI  WOJSKA CZESKIEGO 43 BRNO 75962509950694537528113666,128,2426.00
2015-06-02,PRZELEW UZNANIOWY (NADANO 02-06-2015) DAROWIZNA  MICHA£ WARSZAWSKI  WOJSKA CZESKIEGO 43 BRNO 61579507376794915249867598,291,2135.00
2015-06-03,PRZELEW UZNANIOWY (NADANO 03-06-2015) SK£ADKA CZ£ONKOWSKA ZA MIESI¥C 06-2015  PAWE£ KOWALSKI  WOJSKA CZESKIEGO 43 BRNO 96087422278380788792186817,16,2119.00
2015-06-03,PRZELEW UZNANIOWY (NADANO 03-06-2015) SK£ADKA CZ£ONKOWSKA ZA MIESI¥C 06-2015  DAWID RYBSKI  WOJSKA CZESKIEGO 43 BRNO 96599582404703636610962756,32,2087.00
2015-06-03,PRZELEW UZNANIOWY (NADANO 03-06-2015) SK£ADKA CZ£ONKOWSKA ZA MIESI¥C 06-2015  DAREK NOWAK  WOJSKA CZESKIEGO 43 BRNO 96264850706278025606315315,128,1959.00
2015-06-04,PRZELEW UZNANIOWY (NADANO 04-06-2015) SK£ADKA CZ£ONKOWSKA ZA MIESI¥C 06-2015  BARTUŒ TESTOWSKI  WOJSKA CZESKIEGO 43 BRNO 64473993187105850773704309,32,1927.00
2015-06-04,PRZELEW UZNANIOWY (NADANO 04-06-2015) SK£ADKA CZ£ONKOWSKA ZA MIESI¥C 06-2015  PAWE£ NOWAK  WOJSKA CZESKIEGO 43 BRNO 74056611204858702720147270,128,1799.00
2015-06-05,PRZELEW UZNANIOWY (NADANO 05-06-2015) SK£ADKA CZ£ONKOWSKA ZA MIESI¥C 06-2015  OKTAWIAN NOWAK  WOJSKA CZESKIEGO 43 BRNO 89115457432106996935144268,16,1783.00
2015-06-06,PRZELEW UZNANIOWY (NADANO 06-06-2015) SK£ADKA CZ£ONKOWSKA ZA MIESI¥C 06-2015  DAWID MARKOWSKI  WOJSKA CZESKIEGO 43 BRNO 18926070239051621220275901,64,1719.00
2015-06-06,PRZELEW UZNANIOWY (NADANO 06-06-2015) SK£ADKA CZ£ONKOWSKA ZA MIESI¥C 06-2015  MICHA£ CZARNOWSKI  WOJSKA CZESKIEGO 43 BRNO 80584888817438116590677707,32,1687.00
2015-06-08,PRZELEW UZNANIOWY (NADANO 08-06-2015) SK£ADKA CZ£ONKOWSKA ZA MIESI¥C 06-2015  DAREK NOWAK  WOJSKA CZESKIEGO 43 BRNO 01641888019659271843710050,128,1559.00
2015-06-10,PRZELEW UZNANIOWY (NADANO 10-06-2015) SK£ADKA CZ£ONKOWSKA ZA MIESI¥C 06-2015  MAREK NOWAK  WOJSKA CZESKIEGO 43 BRNO 69504311046805051465907519,16,1543.00
2015-06-10,PRZELEW UZNANIOWY (NADANO 10-06-2015) SK£ADKA CZ£ONKOWSKA ZA MIESI¥C 06-2015  STANIS£AW OWCZAREK  WOJSKA CZESKIEGO 43 BRNO 04279234439190997156499574,32,1511.00
2015-06-12,PRZELEW UZNANIOWY (NADANO 12-06-2015) SK£ADKA CZ£ONKOWSKA ZA MIESI¥C 06-2015  MICHA£ CZARNOWSKI  WOJSKA CZESKIEGO 43 BRNO 98585018771580636226371313,64,1447.00
2015-06-12,PRZELEW UZNANIOWY (NADANO 12-06-2015) SK£ADKA CZ£ONKOWSKA ZA MIESI¥C 06-2015  PAWE£ KOWALSKI  WOJSKA CZESKIEGO 43 BRNO 31059891718937251940506002,32,1415.00
2015-06-13,PRZELEW UZNANIOWY (NADANO 13-06-2015) SK£ADKA CZ£ONKOWSKA ZA MIESI¥C 06-2015  PAWE£ KOWALSKI  WOJSKA CZESKIEGO 43 BRNO 37289221378060892642368978,64,1351.00
2015-06-14,PRZELEW UZNANIOWY (NADANO 14-06-2015) SK£ADKA CZ£ONKOWSKA ZA MIESI¥C 06-2015  MAREK NOWAK  WOJSKA CZESKIEGO 43 BRNO 38702778361198044379677597,128,1223.00
2015-06-15,PRZELEW UZNANIOWY (NADANO 15-06-2015) SK£ADKA CZ£ONKOWSKA ZA MIESI¥C 06-2015  STANIS£AW CZARNOWSKI  WOJSKA CZESKIEGO 43 BRNO 92129071176325655601932343,32,1191.00
2015-06-15,PRZELEW UZNANIOWY (NADANO 15-06-2015) SK£ADKA CZ£ONKOWSKA ZA MIESI¥C 06-2015  £UKASZ NOWAK  WOJSKA CZESKIEGO 43 BRNO 25882254722388912173316335,64,1127.00
2015-06-17,PRZELEW UZNANIOWY (NADANO 17-06-2015) DAROWIZNA  MICHA£ WARSZAWSKI  WOJSKA CZESKIEGO 43 BRNO 61769417499960232660472169,662,465.00
2015-06-18,PRZELEW UZNANIOWY (NADANO 18-06-2015) SK£ADKA CZ£ONKOWSKA ZA MIESI¥C 06-2015  STANIS£AW MARKOWSKI  WOJSKA CZESKIEGO 43 BRNO 14279867352682811988409020,64,401.00
2015-06-20,PRZELEW UZNANIOWY (NADANO 20-06-2015) SK£ADKA CZ£ONKOWSKA ZA MIESI¥C 06-2015  STANIS£AW WARSZAWSKI  WOJSKA CZESKIEGO 43 BRNO 83519255477022154194949868,64,337.00
2015-06-21,PRZELEW OBCI¥¯ENIOWY (NADANO 21-06-2015) COS DO PLACENIA  TAURON  WOJSKA CZESKIEGO 43 BRNO 31396551690790051101024910,-958,1295.00
2015-06-22,PRZELEW OBCI¥¯ENIOWY (NADANO 22-06-2015) COS DO PLACENIA  LOKAL  WOJSKA CZESKIEGO 43 BRNO 61194252903257228849925863,-297,1592.00
2015-06-22,PRZELEW UZNANIOWY (NADANO 22-06-2015) DAROWIZNA  MICHA£ WARSZAWSKI  WOJSKA CZESKIEGO 43 BRNO 79053069839569690276590908,327,1265.00
2015-06-23,PRZELEW UZNANIOWY (NADANO 23-06-2015) SK£ADKA CZ£ONKOWSKA ZA MIESI¥C 06-2015  MAREK TESTOWSKI  WOJSKA CZESKIEGO 43 BRNO 06030621514169678401698284,32,1233.00
2015-06-25,PRZELEW UZNANIOWY (NADANO 25-06-2015) DAROWIZNA  DAREK NOWAK  WOJSKA CZESKIEGO 43 BRNO 87547371885047902640039510,660,573.00
2015-06-25,PRZELEW UZNANIOWY (NADANO 25-06-2015) SK£ADKA CZ£ONKOWSKA ZA MIESI¥C 06-2015  MAREK TESTOWSKI  WOJSKA CZESKIEGO 43 BRNO 40141214011188206266865548,16,557.00
2015-06-26,PRZELEW OBCI¥¯ENIOWY (NADANO 26-06-2015) COS DO PLACENIA  TAURON  WOJSKA CZESKIEGO 43 BRNO 94060321395495255006346209,-880,1437.00
2015-06-28,PRZELEW UZNANIOWY (NADANO 28-06-2015) SK£ADKA CZ£ONKOWSKA ZA MIESI¥C 06-2015  OKTAWIAN NOWAK  WOJSKA CZESKIEGO 43 BRNO 37911041302589477365885833,16,1421.00
2015-06-30,PRZELEW UZNANIOWY (NADANO 30-06-2015) SK£ADKA CZ£ONKOWSKA ZA MIESI¥C 06-2015  BARTUŒ TESTOWSKI  WOJSKA CZESKIEGO 43 BRNO 04810110728455574159859865,16,1405.00
2015-07-02,PRZELEW UZNANIOWY (NADANO 02-07-2015) SK£ADKA CZ£ONKOWSKA ZA MIESI¥C 07-2015  MAREK OWCZAREK  WOJSKA CZESKIEGO 43 BRNO 17203861424164837018213643,64,1341.00
2015-07-03,PRZELEW UZNANIOWY (NADANO 03-07-2015) SK£ADKA CZ£ONKOWSKA ZA MIESI¥C 07-2015  £UKASZ WARSZAWSKI  WOJSKA CZESKIEGO 43 BRNO 51812615173188843640279261,64,1277.00
2015-07-05,PRZELEW UZNANIOWY (NADANO 05-07-2015) SK£ADKA CZ£ONKOWSKA ZA MIESI¥C 07-2015  MICHA£ CZARNOWSKI  WOJSKA CZESKIEGO 43 BRNO 68032472099006213794192994,32,1245.00
2015-07-06,PRZELEW OBCI¥¯ENIOWY (NADANO 06-07-2015) COS DO PLACENIA  TAURON  WOJSKA CZESKIEGO 43 BRNO 73039493829685925583296162,-406,1651.00
2015-07-06,PRZELEW OBCI¥¯ENIOWY (NADANO 06-07-2015) COS DO PLACENIA  TAURON  WOJSKA CZESKIEGO 43 BRNO 89086847877394940093673184,-593,2244.00
2015-07-08,PRZELEW UZNANIOWY (NADANO 08-07-2015) SK£ADKA CZ£ONKOWSKA ZA MIESI¥C 07-2015  MAREK TESTOWSKI  WOJSKA CZESKIEGO 43 BRNO 74890032850595091095041579,32,2212.00
2015-07-10,PRZELEW UZNANIOWY (NADANO 10-07-2015) SK£ADKA CZ£ONKOWSKA ZA MIESI¥C 07-2015  STANIS£AW WARSZAWSKI  WOJSKA CZESKIEGO 43 BRNO 82712628706110135455386534,128,2084.00
2015-07-10,PRZELEW UZNANIOWY (NADANO 10-07-2015) SK£ADKA CZ£ONKOWSKA ZA MIESI¥C 07-2015  DAWID MARKOWSKI  WOJSKA CZESKIEGO 43 BRNO 58472462448690906828134909,128,1956.00
2015-07-11,PRZELEW UZNANIOWY (NADANO 11-07-2015) DAROWIZNA  BARTUŒ NOWAK  WOJSKA CZESKIEGO 43 BRNO 25790684899848845136269160,959,997.00
2015-07-12,PRZELEW UZNANIOWY (NADANO 12-07-2015) SK£ADKA CZ£ONKOWSKA ZA MIESI¥C 07-2015  OKTAWIAN PROSTACKI  WOJSKA CZESKIEGO 43 BRNO 62604062064145130738536878,32,965.00
2015-07-13,PRZELEW UZNANIOWY (NADANO 13-07-2015) DAROWIZNA  PAWE£ NOWAK  WOJSKA CZESKIEGO 43 BRNO 96884203492641094673015768,410,555.00
2015-07-14,PRZELEW UZNANIOWY (NADANO 14-07-2015) SK£ADKA CZ£ONKOWSKA ZA MIESI¥C 07-2015  OKTAWIAN PROSTACKI  WOJSKA CZESKIEGO 43 BRNO 84496579881489559933602985,16,539.00
2015-07-16,PRZELEW UZNANIOWY (NADANO 16-07-2015) SK£ADKA CZ£ONKOWSKA ZA MIESI¥C 07-2015  PAWE£ KOWALSKI  WOJSKA CZESKIEGO 43 BRNO 08850778881182724048182654,16,523.00
2015-07-18,PRZELEW UZNANIOWY (NADANO 18-07-2015) SK£ADKA CZ£ONKOWSKA ZA MIESI¥C 07-2015  DAREK NOWAK  WOJSKA CZESKIEGO 43 BRNO 93412679043208460275587654,16,507.00
2015-07-18,PRZELEW UZNANIOWY (NADANO 18-07-2015) SK£ADKA CZ£ONKOWSKA ZA MIESI¥C 07-2015  MAREK STAROWSKI  WOJSKA CZESKIEGO 43 BRNO 91869594593173285501049567,32,475.00
2015-07-20,PRZELEW UZNANIOWY (NADANO 20-07-2015) SK£ADKA CZ£ONKOWSKA ZA MIESI¥C 07-2015  MICHA£ WARSZAWSKI  WOJSKA CZESKIEGO 43 BRNO 65243343039811994699595666,128,347.00
2015-07-20,PRZELEW UZNANIOWY (NADANO 20-07-2015) SK£ADKA CZ£ONKOWSKA ZA MIESI¥C 07-2015  STANIS£AW CZARNOWSKI  WOJSKA CZESKIEGO 43 BRNO 86190586466418591681881352,128,219.00
2015-07-21,PRZELEW UZNANIOWY (NADANO 21-07-2015) SK£ADKA CZ£ONKOWSKA ZA MIESI¥C 07-2015  PAWE£ KOWALSKI  WOJSKA CZESKIEGO 43 BRNO 20519231899110871728422750,32,187.00
2015-07-22,PRZELEW UZNANIOWY (NADANO 22-07-2015) SK£ADKA CZ£ONKOWSKA ZA MIESI¥C 07-2015  MICHA£ WARSZAWSKI  WOJSKA CZESKIEGO 43 BRNO 03495885059045578450918894,128,59.00
2015-07-22,PRZELEW UZNANIOWY (NADANO 22-07-2015) SK£ADKA CZ£ONKOWSKA ZA MIESI¥C 07-2015  MAREK STAROWSKI  WOJSKA CZESKIEGO 43 BRNO 65247070685936634205194433,32,27.00
2015-07-24,PRZELEW UZNANIOWY (NADANO 24-07-2015) SK£ADKA CZ£ONKOWSKA ZA MIESI¥C 07-2015  BARTUŒ CZARNOWSKI  WOJSKA CZESKIEGO 43 BRNO 92873860337257011342045944,32,-5.00
2015-07-26,PRZELEW UZNANIOWY (NADANO 26-07-2015) SK£ADKA CZ£ONKOWSKA ZA MIESI¥C 07-2015  MAREK OWCZAREK  WOJSKA CZESKIEGO 43 BRNO 04186618470531094509425347,64,-69.00
2015-07-28,PRZELEW UZNANIOWY (NADANO 28-07-2015) SK£ADKA CZ£ONKOWSKA ZA MIESI¥C 07-2015  HENRYK CHOLERAWIECKI  WOJSKA CZESKIEGO 43 BRNO 62438852344963059604325526,32,-101.00
2015-07-28,PRZELEW UZNANIOWY (NADANO 28-07-2015) SK£ADKA CZ£ONKOWSKA ZA MIESI¥C 07-2015  £UKASZ NOWAK  WOJSKA CZESKIEGO 43 BRNO 08388419211942326938390355,64,-165.00
2015-07-30,PRZELEW UZNANIOWY (NADANO 30-07-2015) SK£ADKA CZ£ONKOWSKA ZA MIESI¥C 07-2015  STANIS£AW MARKOWSKI  WOJSKA CZESKIEGO 43 BRNO 39015773280769838602174166,32,-197.00
2015-07-30,PRZELEW OBCI¥¯ENIOWY (NADANO 30-07-2015) COS DO PLACENIA  LOKAL  WOJSKA CZESKIEGO 43 BRNO 68143853345846515476794002,-293,96.00
2015-08-01,PRZELEW UZNANIOWY (NADANO 01-08-2015) SK£ADKA CZ£ONKOWSKA ZA MIESI¥C 08-2015  STANIS£AW STAROWSKI  WOJSKA CZESKIEGO 43 BRNO 66047614246324324652943282,64,32.00
2015-08-02,PRZELEW UZNANIOWY (NADANO 02-08-2015) SK£ADKA CZ£ONKOWSKA ZA MIESI¥C 08-2015  BARTUŒ CZARNOWSKI  WOJSKA CZESKIEGO 43 BRNO 10172324898768541978411780,64,-32.00
2015-08-03,PRZELEW UZNANIOWY (NADANO 03-08-2015) SK£ADKA CZ£ONKOWSKA ZA MIESI¥C 08-2015  £UKASZ NOWAK  WOJSKA CZESKIEGO 43 BRNO 62150776182772387352694631,32,-64.00
2015-08-03,PRZELEW UZNANIOWY (NADANO 03-08-2015) SK£ADKA CZ£ONKOWSKA ZA MIESI¥C 08-2015  MAREK NOWAK  WOJSKA CZESKIEGO 43 BRNO 62645194179758376093172960,128,-192.00
2015-08-04,PRZELEW UZNANIOWY (NADANO 04-08-2015) DAROWIZNA  MICHA£ KOWALSKI  WOJSKA CZESKIEGO 43 BRNO 25930546668505928332259798,660,-852.00
2015-08-05,PRZELEW UZNANIOWY (NADANO 05-08-2015) SK£ADKA CZ£ONKOWSKA ZA MIESI¥C 08-2015  STANIS£AW CZARNOWSKI  WOJSKA CZESKIEGO 43 BRNO 27858051518387507808480312,64,-916.00
2015-08-06,PRZELEW UZNANIOWY (NADANO 06-08-2015) SK£ADKA CZ£ONKOWSKA ZA MIESI¥C 08-2015  STANIS£AW MARKOWSKI  WOJSKA CZESKIEGO 43 BRNO 34595247259319641679385873,32,-948.00
2015-08-08,PRZELEW UZNANIOWY (NADANO 08-08-2015) SK£ADKA CZ£ONKOWSKA ZA MIESI¥C 08-2015  MICHA£ KOWALSKI  WOJSKA CZESKIEGO 43 BRNO 11493769108525492452357296,32,-980.00
2015-08-09,PRZELEW UZNANIOWY (NADANO 09-08-2015) SK£ADKA CZ£ONKOWSKA ZA MIESI¥C 08-2015  MAREK CZARNOWSKI  WOJSKA CZESKIEGO 43 BRNO 43074103495082155038481954,128,-1108.00
2015-08-09,PRZELEW UZNANIOWY (NADANO 09-08-2015) SK£ADKA CZ£ONKOWSKA ZA MIESI¥C 08-2015  BARTUŒ NOWAK  WOJSKA CZESKIEGO 43 BRNO 17040439934295182651883897,16,-1124.00
2015-08-10,PRZELEW OBCI¥¯ENIOWY (NADANO 10-08-2015) COS DO PLACENIA  TAURON  WOJSKA CZESKIEGO 43 BRNO 68576185666104418165542444,-668,-456.00
2015-08-12,PRZELEW UZNANIOWY (NADANO 12-08-2015) SK£ADKA CZ£ONKOWSKA ZA MIESI¥C 08-2015  MAREK STAROWSKI  WOJSKA CZESKIEGO 43 BRNO 30499953778022353381235893,16,-472.00
2015-08-13,PRZELEW UZNANIOWY (NADANO 13-08-2015) SK£ADKA CZ£ONKOWSKA ZA MIESI¥C 08-2015  DAWID NOWAK  WOJSKA CZESKIEGO 43 BRNO 11561856415884284200027587,64,-536.00
2015-08-15,PRZELEW UZNANIOWY (NADANO 15-08-2015) SK£ADKA CZ£ONKOWSKA ZA MIESI¥C 08-2015  DAWID NOWAK  WOJSKA CZESKIEGO 43 BRNO 20472605901811913615649272,64,-600.00
2015-08-15,PRZELEW UZNANIOWY (NADANO 15-08-2015) SK£ADKA CZ£ONKOWSKA ZA MIESI¥C 08-2015  £UKASZ WARSZAWSKI  WOJSKA CZESKIEGO 43 BRNO 06364456034415386752225609,32,-632.00
2015-08-16,PRZELEW UZNANIOWY (NADANO 16-08-2015) SK£ADKA CZ£ONKOWSKA ZA MIESI¥C 08-2015  OKTAWIAN NOWAK  WOJSKA CZESKIEGO 43 BRNO 67088566566712959858514556,32,-664.00
2015-08-17,PRZELEW UZNANIOWY (NADANO 17-08-2015) SK£ADKA CZ£ONKOWSKA ZA MIESI¥C 08-2015  MAREK TESTOWSKI  WOJSKA CZESKIEGO 43 BRNO 03977363849120276818631144,64,-728.00
2015-08-17,PRZELEW UZNANIOWY (NADANO 17-08-2015) SK£ADKA CZ£ONKOWSKA ZA MIESI¥C 08-2015  BARTUŒ CZARNOWSKI  WOJSKA CZESKIEGO 43 BRNO 26200596975908119856020296,32,-760.00
2015-08-18,PRZELEW UZNANIOWY (NADANO 18-08-2015) SK£ADKA CZ£ONKOWSKA ZA MIESI¥C 08-2015  STANIS£AW WARSZAWSKI  WOJSKA CZESKIEGO 43 BRNO 60428486654359219781530218,32,-792.00
2015-08-20,PRZELEW UZNANIOWY (NADANO 20-08-2015) SK£ADKA CZ£ONKOWSKA ZA MIESI¥C 08-2015  DAWID MARKOWSKI  WOJSKA CZESKIEGO 43 BRNO 73992721880697554600483366,64,-856.00
2015-08-20,PRZELEW UZNANIOWY (NADANO 20-08-2015) SK£ADKA CZ£ONKOWSKA ZA MIESI¥C 08-2015  MAREK NOWAK  WOJSKA CZESKIEGO 43 BRNO 32120692322657976933439277,32,-888.00
2015-08-20,PRZELEW UZNANIOWY (NADANO 20-08-2015) DAROWIZNA  STANIS£AW OWCZAREK  WOJSKA CZESKIEGO 43 BRNO 09413343266528834080979420,431,-1319.00
2015-08-21,PRZELEW UZNANIOWY (NADANO 21-08-2015) SK£ADKA CZ£ONKOWSKA ZA MIESI¥C 08-2015  MAREK NOWAK  WOJSKA CZESKIEGO 43 BRNO 87099598889548593915543847,64,-1383.00
2015-08-22,PRZELEW UZNANIOWY (NADANO 22-08-2015) SK£ADKA CZ£ONKOWSKA ZA MIESI¥C 08-2015  MAREK NOWAK  WOJSKA CZESKIEGO 43 BRNO 08735318332031866023758207,16,-1399.00
2015-08-22,PRZELEW UZNANIOWY (NADANO 22-08-2015) SK£ADKA CZ£ONKOWSKA ZA MIESI¥C 08-2015  DAWID NOWAK  WOJSKA CZESKIEGO 43 BRNO 46356060675348731505079447,32,-1431.00
2015-08-22,PRZELEW UZNANIOWY (NADANO 22-08-2015) SK£ADKA CZ£ONKOWSKA ZA MIESI¥C 08-2015  DAWID MARKOWSKI  WOJSKA CZESKIEGO 43 BRNO 10355498180917188032831474,32,-1463.00
2015-08-24,PRZELEW OBCI¥¯ENIOWY (NADANO 24-08-2015) COS DO PLACENIA  TAURON  WOJSKA CZESKIEGO 43 BRNO 47645861727435641381302735,-976,-487.00
2015-08-24,PRZELEW UZNANIOWY (NADANO 24-08-2015) DAROWIZNA  £UKASZ NOWAK  WOJSKA CZESKIEGO 43 BRNO 63546674491711743490207161,548,-1035.00
2015-08-24,PRZELEW UZNANIOWY (NADANO 24-08-2015) SK£ADKA CZ£ONKOWSKA ZA MIESI¥C 08-2015  BARTUŒ CZARNOWSKI  WOJSKA CZESKIEGO 43 BRNO 26159660895175145142875217,16,-1051.00
2015-08-24,PRZELEW UZNANIOWY (NADANO 24-08-2015) SK£ADKA CZ£ONKOWSKA ZA MIESI¥C 08-2015  DAWID MARKOWSKI  WOJSKA CZESKIEGO 43 BRNO 22559300430410200353249271,32,-1083.00
2015-08-26,PRZELEW UZNANIOWY (NADANO 26-08-2015) SK£ADKA CZ£ONKOWSKA ZA MIESI¥C 08-2015  DAWID RYBSKI  WOJSKA CZESKIEGO 43 BRNO 38838963733579580388082443,64,-1147.00
2015-08-28,PRZELEW UZNANIOWY (NADANO 28-08-2015) SK£ADKA CZ£ONKOWSKA ZA MIESI¥C 08-2015  DAWID NOWAK  WOJSKA CZESKIEGO 43 BRNO 83777699671633822021923717,16,-1163.00
2015-08-29,PRZELEW UZNANIOWY (NADANO 29-08-2015) SK£ADKA CZ£ONKOWSKA ZA MIESI¥C 08-2015  DAWID NOWAK  WOJSKA CZESKIEGO 43 BRNO 70209047591554126359531271,128,-1291.00
2015-08-31,PRZELEW OBCI¥¯ENIOWY (NADANO 31-08-2015) COS DO PLACENIA  TAURON  WOJSKA CZESKIEGO 43 BRNO 40295067721127855976790468,-271,-1020.00
2015-09-02,PRZELEW UZNANIOWY (NADANO 02-09-2015) SK£ADKA CZ£ONKOWSKA ZA MIESI¥C 09-2015  DAWID NOWAK  WOJSKA CZESKIEGO 43 BRNO 78474227883921446176904477,64,-1084.00
2015-09-04,PRZELEW UZNANIOWY (NADANO 04-09-2015) SK£ADKA CZ£ONKOWSKA ZA MIESI¥C 09-2015  HENRYK CHOLERAWIECKI  WOJSKA CZESKIEGO 43 BRNO 47069929155046822190640533,32,-1116.00
2015-09-04,PRZELEW OBCI¥¯ENIOWY (NADANO 04-09-2015) COS DO PLACENIA  TAURON  WOJSKA CZESKIEGO 43 BRNO 84717209747022943550389780,-317,-799.00
2015-09-06,PRZELEW UZNANIOWY (NADANO 06-09-2015) DAROWIZNA  HENRYK KOWALSKI  WOJSKA CZESKIEGO 43 BRNO 39645412602094003030109467,718,-1517.00
2015-09-08,PRZELEW UZNANIOWY (NADANO 08-09-2015) SK£ADKA CZ£ONKOWSKA ZA MIESI¥C 09-2015  DAWID NOWAK  WOJSKA CZESKIEGO 43 BRNO 17693462294426681006034840,64,-1581.00
2015-09-09,PRZELEW UZNANIOWY (NADANO 09-09-2015) SK£ADKA CZ£ONKOWSKA ZA MIESI¥C 09-2015  HENRYK KOWALSKI  WOJSKA CZESKIEGO 43 BRNO 99353436259246207393677166,16,-1597.00
2015-09-11,PRZELEW UZNANIOWY (NADANO 11-09-2015) SK£ADKA CZ£ONKOWSKA ZA MIESI¥C 09-2015  STANIS£AW MARKOWSKI  WOJSKA CZESKIEGO 43 BRNO 57615043664366185192077454,64,-1661.00
2015-09-13,PRZELEW UZNANIOWY (NADANO 13-09-2015) SK£ADKA CZ£ONKOWSKA ZA MIESI¥C 09-2015  BARTUŒ CZARNOWSKI  WOJSKA CZESKIEGO 43 BRNO 02005728892054178921747550,128,-1789.00
2015-09-13,PRZELEW UZNANIOWY (NADANO 13-09-2015) SK£ADKA CZ£ONKOWSKA ZA MIESI¥C 09-2015  PAWE£ KOWALSKI  WOJSKA CZESKIEGO 43 BRNO 25878075264065653031399369,16,-1805.00
2015-09-14,PRZELEW UZNANIOWY (NADANO 14-09-2015) DAROWIZNA  BARTUŒ NOWAK  WOJSKA CZESKIEGO 43 BRNO 55379274844741875418358901,825,-2630.00
2015-09-14,PRZELEW UZNANIOWY (NADANO 14-09-2015) SK£ADKA CZ£ONKOWSKA ZA MIESI¥C 09-2015  £UKASZ WARSZAWSKI  WOJSKA CZESKIEGO 43 BRNO 12418744458488456562105871,64,-2694.00
2015-09-16,PRZELEW UZNANIOWY (NADANO 16-09-2015) SK£ADKA CZ£ONKOWSKA ZA MIESI¥C 09-2015  PAWE£ NOWAK  WOJSKA CZESKIEGO 43 BRNO 87674628127591903281706117,32,-2726.00
2015-09-18,PRZELEW UZNANIOWY (NADANO 18-09-2015) SK£ADKA CZ£ONKOWSKA ZA MIESI¥C 09-2015  STANIS£AW CZARNOWSKI  WOJSKA CZESKIEGO 43 BRNO 59283240903618269621797596,16,-2742.00
2015-09-20,PRZELEW UZNANIOWY (NADANO 20-09-2015) SK£ADKA CZ£ONKOWSKA ZA MIESI¥C 09-2015  STANIS£AW CZARNOWSKI  WOJSKA CZESKIEGO 43 BRNO 11509176243372331430508767,128,-2870.00
2015-09-22,PRZELEW UZNANIOWY (NADANO 22-09-2015) DAROWIZNA  MAREK NOWAK  WOJSKA CZESKIEGO 43 BRNO 11781896961918237131370405,903,-3773.00
2015-09-23,PRZELEW UZNANIOWY (NADANO 23-09-2015) SK£ADKA CZ£ONKOWSKA ZA MIESI¥C 09-2015  DAREK NOWAK  WOJSKA CZESKIEGO 43 BRNO 60930838124413542966782532,16,-3789.00
2015-09-25,PRZELEW UZNANIOWY (NADANO 25-09-2015) SK£ADKA CZ£ONKOWSKA ZA MIESI¥C 09-2015  HENRYK CHOLERAWIECKI  WOJSKA CZESKIEGO 43 BRNO 72676817631891754110270708,128,-3917.00
2015-09-26,PRZELEW UZNANIOWY (NADANO 26-09-2015) SK£ADKA CZ£ONKOWSKA ZA MIESI¥C 09-2015  HENRYK KOWALSKI  WOJSKA CZESKIEGO 43 BRNO 75959971504295674925143886,16,-3933.00
2015-09-26,PRZELEW UZNANIOWY (NADANO 26-09-2015) SK£ADKA CZ£ONKOWSKA ZA MIESI¥C 09-2015  MAREK CZARNOWSKI  WOJSKA CZESKIEGO 43 BRNO 94162825630724989619195638,64,-3997.00
2015-09-26,PRZELEW UZNANIOWY (NADANO 26-09-2015) SK£ADKA CZ£ONKOWSKA ZA MIESI¥C 09-2015  PAWE£ NOWAK  WOJSKA CZESKIEGO 43 BRNO 33237312418542083262392260,32,-4029.00
2015-09-26,PRZELEW OBCI¥¯ENIOWY (NADANO 26-09-2015) COS DO PLACENIA  UPC  WOJSKA CZESKIEGO 43 BRNO 27799836802033015628936447,-510,-3519.00
2015-09-27,PRZELEW UZNANIOWY (NADANO 27-09-2015) SK£ADKA CZ£ONKOWSKA ZA MIESI¥C 09-2015  PAWE£ KOWALSKI  WOJSKA CZESKIEGO 43 BRNO 61432728860404279570954070,16,-3535.00
2015-09-28,PRZELEW UZNANIOWY (NADANO 28-09-2015) SK£ADKA CZ£ONKOWSKA ZA MIESI¥C 09-2015  £UKASZ NOWAK  WOJSKA CZESKIEGO 43 BRNO 72102453569757745765377969,64,-3599.00
2015-09-29,PRZELEW OBCI¥¯ENIOWY (NADANO 29-09-2015) COS DO PLACENIA  LOKAL  WOJSKA CZESKIEGO 43 BRNO 59388141841448602169677107,-538,-3061.00
2015-09-30,PRZELEW UZNANIOWY (NADANO 30-09-2015) SK£ADKA CZ£ONKOWSKA ZA MIESI¥C 09-2015  DAWID MARKOWSKI  WOJSKA CZESKIEGO 43 BRNO 29188662335510926892575000,64,-3125.00
2015-10-01,PRZELEW UZNANIOWY (NADANO 01-10-2015) SK£ADKA CZ£ONKOWSKA ZA MIESI¥C 10-2015  BARTUŒ NOWAK  WOJSKA CZESKIEGO 43 BRNO 10148021368210536679919937,16,-3141.00
2015-10-02,PRZELEW UZNANIOWY (NADANO 02-10-2015) SK£ADKA CZ£ONKOWSKA ZA MIESI¥C 10-2015  OKTAWIAN PROSTACKI  WOJSKA CZESKIEGO 43 BRNO 76636464054955385619597509,32,-3173.00
2015-10-04,PRZELEW UZNANIOWY (NADANO 04-10-2015) SK£ADKA CZ£ONKOWSKA ZA MIESI¥C 10-2015  OKTAWIAN NOWAK  WOJSKA CZESKIEGO 43 BRNO 35774162692504179132373996,32,-3205.00
2015-10-04,PRZELEW UZNANIOWY (NADANO 04-10-2015) SK£ADKA CZ£ONKOWSKA ZA MIESI¥C 10-2015  MICHA£ WARSZAWSKI  WOJSKA CZESKIEGO 43 BRNO 89364371157359028077447223,128,-3333.00
2015-10-04,PRZELEW UZNANIOWY (NADANO 04-10-2015) SK£ADKA CZ£ONKOWSKA ZA MIESI¥C 10-2015  BARTUŒ NOWAK  WOJSKA CZESKIEGO 43 BRNO 79442972386997877744684330,16,-3349.00
2015-10-05,PRZELEW UZNANIOWY (NADANO 05-10-2015) SK£ADKA CZ£ONKOWSKA ZA MIESI¥C 10-2015  STANIS£AW STAROWSKI  WOJSKA CZESKIEGO 43 BRNO 88724876549084988862687448,32,-3381.00
2015-10-05,PRZELEW UZNANIOWY (NADANO 05-10-2015) SK£ADKA CZ£ONKOWSKA ZA MIESI¥C 10-2015  £UKASZ WARSZAWSKI  WOJSKA CZESKIEGO 43 BRNO 12598204111545607282751667,64,-3445.00
2015-10-07,PRZELEW OBCI¥¯ENIOWY (NADANO 07-10-2015) COS DO PLACENIA  LOKAL  WOJSKA CZESKIEGO 43 BRNO 86349334902762343057010581,-463,-2982.00
2015-10-09,PRZELEW UZNANIOWY (NADANO 09-10-2015) SK£ADKA CZ£ONKOWSKA ZA MIESI¥C 10-2015  HENRYK KOWALSKI  WOJSKA CZESKIEGO 43 BRNO 00816294427491701946038487,64,-3046.00
2015-10-10,PRZELEW UZNANIOWY (NADANO 10-10-2015) SK£ADKA CZ£ONKOWSKA ZA MIESI¥C 10-2015  STANIS£AW OWCZAREK  WOJSKA CZESKIEGO 43 BRNO 80641062735363317398600037,64,-3110.00
2015-10-12,PRZELEW UZNANIOWY (NADANO 12-10-2015) SK£ADKA CZ£ONKOWSKA ZA MIESI¥C 10-2015  MAREK NOWAK  WOJSKA CZESKIEGO 43 BRNO 38970917427314450985066769,32,-3142.00
2015-10-12,PRZELEW UZNANIOWY (NADANO 12-10-2015) SK£ADKA CZ£ONKOWSKA ZA MIESI¥C 10-2015  HENRYK KOWALSKI  WOJSKA CZESKIEGO 43 BRNO 51145685422346066510796877,32,-3174.00
2015-10-14,PRZELEW UZNANIOWY (NADANO 14-10-2015) DAROWIZNA  HENRYK CHOLERAWIECKI  WOJSKA CZESKIEGO 43 BRNO 34659287299532775983178159,557,-3731.00
2015-10-15,PRZELEW UZNANIOWY (NADANO 15-10-2015) SK£ADKA CZ£ONKOWSKA ZA MIESI¥C 10-2015  DAWID MARKOWSKI  WOJSKA CZESKIEGO 43 BRNO 31947107959982584466791235,32,-3763.00
2015-10-15,PRZELEW UZNANIOWY (NADANO 15-10-2015) SK£ADKA CZ£ONKOWSKA ZA MIESI¥C 10-2015  DAREK NOWAK  WOJSKA CZESKIEGO 43 BRNO 29078687395593328955137478,16,-3779.00
2015-10-15,PRZELEW UZNANIOWY (NADANO 15-10-2015) SK£ADKA CZ£ONKOWSKA ZA MIESI¥C 10-2015  MAREK NOWAK  WOJSKA CZESKIEGO 43 BRNO 48209916561303433950211129,32,-3811.00
2015-10-17,PRZELEW UZNANIOWY (NADANO 17-10-2015) SK£ADKA CZ£ONKOWSKA ZA MIESI¥C 10-2015  BARTUŒ CZARNOWSKI  WOJSKA CZESKIEGO 43 BRNO 17005486852391786030560449,64,-3875.00
2015-10-17,PRZELEW OBCI¥¯ENIOWY (NADANO 17-10-2015) COS DO PLACENIA  LOKAL  WOJSKA CZESKIEGO 43 BRNO 15705833215112548423409511,-541,-3334.00
2015-10-19,PRZELEW UZNANIOWY (NADANO 19-10-2015) SK£ADKA CZ£ONKOWSKA ZA MIESI¥C 10-2015  BARTUŒ TESTOWSKI  WOJSKA CZESKIEGO 43 BRNO 42726945100120528192955109,128,-3462.00
2015-10-19,PRZELEW UZNANIOWY (NADANO 19-10-2015) SK£ADKA CZ£ONKOWSKA ZA MIESI¥C 10-2015  OKTAWIAN NOWAK  WOJSKA CZESKIEGO 43 BRNO 38835042362952291380137139,16,-3478.00
2015-10-19,PRZELEW UZNANIOWY (NADANO 19-10-2015) SK£ADKA CZ£ONKOWSKA ZA MIESI¥C 10-2015  BARTUŒ TESTOWSKI  WOJSKA CZESKIEGO 43 BRNO 43042073692057259524331002,64,-3542.00
2015-10-20,PRZELEW UZNANIOWY (NADANO 20-10-2015) SK£ADKA CZ£ONKOWSKA ZA MIESI¥C 10-2015  HENRYK CHOLERAWIECKI  WOJSKA CZESKIEGO 43 BRNO 75694841813029116299006669,32,-3574.00
2015-10-22,PRZELEW UZNANIOWY (NADANO 22-10-2015) DAROWIZNA  MAREK TESTOWSKI  WOJSKA CZESKIEGO 43 BRNO 44438477609369997855149981,898,-4472.00
2015-10-22,PRZELEW UZNANIOWY (NADANO 22-10-2015) SK£ADKA CZ£ONKOWSKA ZA MIESI¥C 10-2015  £UKASZ WARSZAWSKI  WOJSKA CZESKIEGO 43 BRNO 29844321901529620025690312,128,-4600.00
2015-10-24,PRZELEW OBCI¥¯ENIOWY (NADANO 24-10-2015) COS DO PLACENIA  TAURON  WOJSKA CZESKIEGO 43 BRNO 86734617692482125519987743,-681,-3919.00
2015-10-25,PRZELEW UZNANIOWY (NADANO 25-10-2015) SK£ADKA CZ£ONKOWSKA ZA MIESI¥C 10-2015  OKTAWIAN PROSTACKI  WOJSKA CZESKIEGO 43 BRNO 66104729686493406367634255,128,-4047.00
2015-10-27,PRZELEW UZNANIOWY (NADANO 27-10-2015) SK£ADKA CZ£ONKOWSKA ZA MIESI¥C 10-2015  PAWE£ NOWAK  WOJSKA CZESKIEGO 43 BRNO 06505664739355052095839299,64,-4111.00
2015-10-29,PRZELEW UZNANIOWY (NADANO 29-10-2015) SK£ADKA CZ£ONKOWSKA ZA MIESI¥C 10-2015  STANIS£AW OWCZAREK  WOJSKA CZESKIEGO 43 BRNO 08473584233704673100068376,32,-4143.00
2015-10-30,PRZELEW UZNANIOWY (NADANO 30-10-2015) SK£ADKA CZ£ONKOWSKA ZA MIESI¥C 10-2015  DAWID RYBSKI  WOJSKA CZESKIEGO 43 BRNO 66300190372183737089942592,16,-4159.00
2015-10-30,PRZELEW UZNANIOWY (NADANO 30-10-2015) SK£ADKA CZ£ONKOWSKA ZA MIESI¥C 10-2015  MAREK CZARNOWSKI  WOJSKA CZESKIEGO 43 BRNO 10821745571222508851870942,128,-4287.00
2015-11-01,PRZELEW UZNANIOWY (NADANO 01-11-2015) SK£ADKA CZ£ONKOWSKA ZA MIESI¥C 11-2015  PAWE£ NOWAK  WOJSKA CZESKIEGO 43 BRNO 54949230332782842420217098,32,-4319.00
2015-11-01,PRZELEW UZNANIOWY (NADANO 01-11-2015) SK£ADKA CZ£ONKOWSKA ZA MIESI¥C 11-2015  £UKASZ STAROWSKI  WOJSKA CZESKIEGO 43 BRNO 77513014367147691211212708,32,-4351.00
2015-11-03,PRZELEW UZNANIOWY (NADANO 03-11-2015) SK£ADKA CZ£ONKOWSKA ZA MIESI¥C 11-2015  STANIS£AW OWCZAREK  WOJSKA CZESKIEGO 43 BRNO 91638722905116219292702173,128,-4479.00
2015-11-04,PRZELEW UZNANIOWY (NADANO 04-11-2015) SK£ADKA CZ£ONKOWSKA ZA MIESI¥C 11-2015  MAREK CZARNOWSKI  WOJSKA CZESKIEGO 43 BRNO 49083791059502183854421234,64,-4543.00
2015-11-05,PRZELEW UZNANIOWY (NADANO 05-11-2015) SK£ADKA CZ£ONKOWSKA ZA MIESI¥C 11-2015  HENRYK KOWALSKI  WOJSKA CZESKIEGO 43 BRNO 36853694184205849997100698,64,-4607.00
2015-11-05,PRZELEW UZNANIOWY (NADANO 05-11-2015) SK£ADKA CZ£ONKOWSKA ZA MIESI¥C 11-2015  MICHA£ CZARNOWSKI  WOJSKA CZESKIEGO 43 BRNO 63751581809160365520145638,64,-4671.00
2015-11-06,PRZELEW OBCI¥¯ENIOWY (NADANO 06-11-2015) COS DO PLACENIA  UPC  WOJSKA CZESKIEGO 43 BRNO 46981360904925801293168388,-541,-4130.00
2015-11-07,PRZELEW UZNANIOWY (NADANO 07-11-2015) SK£ADKA CZ£ONKOWSKA ZA MIESI¥C 11-2015  BARTUŒ TESTOWSKI  WOJSKA CZESKIEGO 43 BRNO 49765019405847129630632020,16,-4146.00
2015-11-08,PRZELEW UZNANIOWY (NADANO 08-11-2015) SK£ADKA CZ£ONKOWSKA ZA MIESI¥C 11-2015  MICHA£ KOWALSKI  WOJSKA CZESKIEGO 43 BRNO 32607365227100069584941242,32,-4178.00
2015-11-10,PRZELEW UZNANIOWY (NADANO 10-11-2015) SK£ADKA CZ£ONKOWSKA ZA MIESI¥C 11-2015  OKTAWIAN NOWAK  WOJSKA CZESKIEGO 43 BRNO 59311325014896316919249524,32,-4210.00
2015-11-12,PRZELEW UZNANIOWY (NADANO 12-11-2015) SK£ADKA CZ£ONKOWSKA ZA MIESI¥C 11-2015  MICHA£ CZARNOWSKI  WOJSKA CZESKIEGO 43 BRNO 52498993378819891292163450,32,-4242.00
2015-11-12,PRZELEW UZNANIOWY (NADANO 12-11-2015) SK£ADKA CZ£ONKOWSKA ZA MIESI¥C 11-2015  STANIS£AW OWCZAREK  WOJSKA CZESKIEGO 43 BRNO 89697385415169223614941683,64,-4306.00
2015-11-14,PRZELEW UZNANIOWY (NADANO 14-11-2015) SK£ADKA CZ£ONKOWSKA ZA MIESI¥C 11-2015  £UKASZ WARSZAWSKI  WOJSKA CZESKIEGO 43 BRNO 11945550182053966484970656,16,-4322.00
2015-11-15,PRZELEW UZNANIOWY (NADANO 15-11-2015) SK£ADKA CZ£ONKOWSKA ZA MIESI¥C 11-2015  OKTAWIAN NOWAK  WOJSKA CZESKIEGO 43 BRNO 42354767138449363543307723,128,-4450.00
2015-11-15,PRZELEW UZNANIOWY (NADANO 15-11-2015) SK£ADKA CZ£ONKOWSKA ZA MIESI¥C 11-2015  PAWE£ NOWAK  WOJSKA CZESKIEGO 43 BRNO 41039869632628147915782163,128,-4578.00
2015-11-17,PRZELEW OBCI¥¯ENIOWY (NADANO 17-11-2015) COS DO PLACENIA  TAURON  WOJSKA CZESKIEGO 43 BRNO 98758804850371621252244578,-741,-3837.00
2015-11-17,PRZELEW UZNANIOWY (NADANO 17-11-2015) SK£ADKA CZ£ONKOWSKA ZA MIESI¥C 11-2015  HENRYK KOWALSKI  WOJSKA CZESKIEGO 43 BRNO 41519416277222397270053557,32,-3869.00
2015-11-17,PRZELEW UZNANIOWY (NADANO 17-11-2015) SK£ADKA CZ£ONKOWSKA ZA MIESI¥C 11-2015  BARTUŒ NOWAK  WOJSKA CZESKIEGO 43 BRNO 00681981903225697405882242,128,-3997.00
2015-11-19,PRZELEW OBCI¥¯ENIOWY (NADANO 19-11-2015) COS DO PLACENIA  TAURON  WOJSKA CZESKIEGO 43 BRNO 27270576411984795096350211,-509,-3488.00
2015-11-21,PRZELEW UZNANIOWY (NADANO 21-11-2015) SK£ADKA CZ£ONKOWSKA ZA MIESI¥C 11-2015  OKTAWIAN RYBSKI  WOJSKA CZESKIEGO 43 BRNO 50278168407917181747445377,32,-3520.00
2015-11-22,PRZELEW UZNANIOWY (NADANO 22-11-2015) SK£ADKA CZ£ONKOWSKA ZA MIESI¥C 11-2015  HENRYK CHOLERAWIECKI  WOJSKA CZESKIEGO 43 BRNO 70638247454039838691521650,128,-3648.00
2015-11-22,PRZELEW UZNANIOWY (NADANO 22-11-2015) SK£ADKA CZ£ONKOWSKA ZA MIESI¥C 11-2015  OKTAWIAN RYBSKI  WOJSKA CZESKIEGO 43 BRNO 75524538337800287573168543,64,-3712.00
2015-11-23,PRZELEW UZNANIOWY (NADANO 23-11-2015) SK£ADKA CZ£ONKOWSKA ZA MIESI¥C 11-2015  DAWID RYBSKI  WOJSKA CZESKIEGO 43 BRNO 97798297700159116891697209,128,-3840.00
2015-11-24,PRZELEW UZNANIOWY (NADANO 24-11-2015) SK£ADKA CZ£ONKOWSKA ZA MIESI¥C 11-2015  HENRYK CHOLERAWIECKI  WOJSKA CZESKIEGO 43 BRNO 68526169179483686187590630,64,-3904.00
2015-11-26,PRZELEW UZNANIOWY (NADANO 26-11-2015) SK£ADKA CZ£ONKOWSKA ZA MIESI¥C 11-2015  OKTAWIAN NOWAK  WOJSKA CZESKIEGO 43 BRNO 46995660279969604332898479,128,-4032.00
2015-11-27,PRZELEW UZNANIOWY (NADANO 27-11-2015) SK£ADKA CZ£ONKOWSKA ZA MIESI¥C 11-2015  STANIS£AW MARKOWSKI  WOJSKA CZESKIEGO 43 BRNO 14236776659104159516426531,32,-4064.00
2015-11-27,PRZELEW UZNANIOWY (NADANO 27-11-2015) SK£ADKA CZ£ONKOWSKA ZA MIESI¥C 11-2015  MAREK STAROWSKI  WOJSKA CZESKIEGO 43 BRNO 76327608218394877232261980,128,-4192.00
2015-11-27,PRZELEW OBCI¥¯ENIOWY (NADANO 27-11-2015) COS DO PLACENIA  UPC  WOJSKA CZESKIEGO 43 BRNO 13732807857559146887554240,-629,-3563.00
2015-11-27,PRZELEW UZNANIOWY (NADANO 27-11-2015) SK£ADKA CZ£ONKOWSKA ZA MIESI¥C 11-2015  BARTUŒ TESTOWSKI  WOJSKA CZESKIEGO 43 BRNO 93671530282343377473240295,32,-3595.00
2015-11-28,PRZELEW UZNANIOWY (NADANO 28-11-2015) SK£ADKA CZ£ONKOWSKA ZA MIESI¥C 11-2015  HENRYK CHOLERAWIECKI  WOJSKA CZESKIEGO 43 BRNO 84516935139369772750585379,64,-3659.00
2015-11-29,PRZELEW UZNANIOWY (NADANO 29-11-2015) SK£ADKA CZ£ONKOWSKA ZA MIESI¥C 11-2015  BARTUŒ CZARNOWSKI  WOJSKA CZESKIEGO 43 BRNO 50691592863297893014684808,32,-3691.00
2015-11-29,PRZELEW UZNANIOWY (NADANO 29-11-2015) SK£ADKA CZ£ONKOWSKA ZA MIESI¥C 11-2015  OKTAWIAN RYBSKI  WOJSKA CZESKIEGO 43 BRNO 35168310710605153509591078,16,-3707.00
2015-12-01,PRZELEW UZNANIOWY (NADANO 01-12-2015) SK£ADKA CZ£ONKOWSKA ZA MIESI¥C 12-2015  STANIS£AW WARSZAWSKI  WOJSKA CZESKIEGO 43 BRNO 57650248472638938256015403,32,-3739.00
2015-12-03,PRZELEW OBCI¥¯ENIOWY (NADANO 03-12-2015) COS DO PLACENIA  LOKAL  WOJSKA CZESKIEGO 43 BRNO 13469970557898755107205719,-815,-2924.00
2015-12-05,PRZELEW UZNANIOWY (NADANO 05-12-2015) SK£ADKA CZ£ONKOWSKA ZA MIESI¥C 12-2015  £UKASZ STAROWSKI  WOJSKA CZESKIEGO 43 BRNO 36954018489188037102203776,64,-2988.00
2015-12-06,PRZELEW UZNANIOWY (NADANO 06-12-2015) SK£ADKA CZ£ONKOWSKA ZA MIESI¥C 12-2015  OKTAWIAN PROSTACKI  WOJSKA CZESKIEGO 43 BRNO 73548427421793149221114197,64,-3052.00
2015-12-08,PRZELEW UZNANIOWY (NADANO 08-12-2015) SK£ADKA CZ£ONKOWSKA ZA MIESI¥C 12-2015  PAWE£ KOWALSKI  WOJSKA CZESKIEGO 43 BRNO 14031638837814636620353415,32,-3084.00
2015-12-08,PRZELEW UZNANIOWY (NADANO 08-12-2015) SK£ADKA CZ£ONKOWSKA ZA MIESI¥C 12-2015  DAREK NOWAK  WOJSKA CZESKIEGO 43 BRNO 79427590124454889645147642,128,-3212.00
2015-12-08,PRZELEW UZNANIOWY (NADANO 08-12-2015) SK£ADKA CZ£ONKOWSKA ZA MIESI¥C 12-2015  STANIS£AW STAROWSKI  WOJSKA CZESKIEGO 43 BRNO 75240059460425618380967509,128,-3340.00
2015-12-10,PRZELEW UZNANIOWY (NADANO 10-12-2015) SK£ADKA CZ£ONKOWSKA ZA MIESI¥C 12-2015  STANIS£AW OWCZAREK  WOJSKA CZESKIEGO 43 BRNO 75440100422101374633733849,128,-3468.00
2015-12-11,PRZELEW UZNANIOWY (NADANO 11-12-2015) SK£ADKA CZ£ONKOWSKA ZA MIESI¥C 12-2015  PAWE£ KOWALSKI  WOJSKA CZESKIEGO 43 BRNO 77139588164882053296144620,32,-3500.00
2015-12-13,PRZELEW UZNANIOWY (NADANO 13-12-2015) DAROWIZNA  OKTAWIAN NOWAK  WOJSKA CZESKIEGO 43 BRNO 89305542973748601389806087,979,-4479.00
2015-12-13,PRZELEW UZNANIOWY (NADANO 13-12-2015) SK£ADKA CZ£ONKOWSKA ZA MIESI¥C 12-2015  MICHA£ KOWALSKI  WOJSKA CZESKIEGO 43 BRNO 32485895477159608184434480,128,-4607.00
2015-12-15,PRZELEW UZNANIOWY (NADANO 15-12-2015) SK£ADKA CZ£ONKOWSKA ZA MIESI¥C 12-2015  £UKASZ STAROWSKI  WOJSKA CZESKIEGO 43 BRNO 28522576574719810399524452,32,-4639.00
2015-12-16,PRZELEW UZNANIOWY (NADANO 16-12-2015) SK£ADKA CZ£ONKOWSKA ZA MIESI¥C 12-2015  MAREK TESTOWSKI  WOJSKA CZESKIEGO 43 BRNO 59323197802836848083509192,64,-4703.00
2015-12-16,PRZELEW UZNANIOWY (NADANO 16-12-2015) SK£ADKA CZ£ONKOWSKA ZA MIESI¥C 12-2015  £UKASZ NOWAK  WOJSKA CZESKIEGO 43 BRNO 69524614431226612509172606,16,-4719.00
2015-12-16,PRZELEW UZNANIOWY (NADANO 16-12-2015) SK£ADKA CZ£ONKOWSKA ZA MIESI¥C 12-2015  £UKASZ WARSZAWSKI  WOJSKA CZESKIEGO 43 BRNO 87354617465149845051721194,32,-4751.00
2015-12-18,PRZELEW UZNANIOWY (NADANO 18-12-2015) SK£ADKA CZ£ONKOWSKA ZA MIESI¥C 12-2015  OKTAWIAN RYBSKI  WOJSKA CZESKIEGO 43 BRNO 99444606196304969393251403,64,-4815.00
2015-12-20,PRZELEW OBCI¥¯ENIOWY (NADANO 20-12-2015) COS DO PLACENIA  TAURON  WOJSKA CZESKIEGO 43 BRNO 33684313827240676429215786,-413,-4402.00
2015-12-21,PRZELEW UZNANIOWY (NADANO 21-12-2015) SK£ADKA CZ£ONKOWSKA ZA MIESI¥C 12-2015  DAWID MARKOWSKI  WOJSKA CZESKIEGO 43 BRNO 01112145025576108531229682,32,-4434.00
2015-12-21,PRZELEW UZNANIOWY (NADANO 21-12-2015) SK£ADKA CZ£ONKOWSKA ZA MIESI¥C 12-2015  OKTAWIAN NOWAK  WOJSKA CZESKIEGO 43 BRNO 76854776487899842950127016,128,-4562.00
2015-12-21,PRZELEW UZNANIOWY (NADANO 21-12-2015) SK£ADKA CZ£ONKOWSKA ZA MIESI¥C 12-2015  BARTUŒ TESTOWSKI  WOJSKA CZESKIEGO 43 BRNO 50258523612966222842904929,64,-4626.00
2015-12-23,PRZELEW UZNANIOWY (NADANO 23-12-2015) DAROWIZNA  STANIS£AW MARKOWSKI  WOJSKA CZESKIEGO 43 BRNO 65398576631897703244556173,573,-5199.00
2015-12-25,PRZELEW UZNANIOWY (NADANO 25-12-2015) SK£ADKA CZ£ONKOWSKA ZA MIESI¥C 12-2015  HENRYK KOWALSKI  WOJSKA CZESKIEGO 43 BRNO 32366555824984148600064727,128,-5327.00
2015-12-25,PRZELEW UZNANIOWY (NADANO 25-12-2015) SK£ADKA CZ£ONKOWSKA ZA MIESI¥C 12-2015  DAWID MARKOWSKI  WOJSKA CZESKIEGO 43 BRNO 76948329825817188662806767,64,-5391.00
2015-12-25,PRZELEW UZNANIOWY (NADANO 25-12-2015) SK£ADKA CZ£ONKOWSKA ZA MIESI¥C 12-2015  HENRYK CHOLERAWIECKI  WOJSKA CZESKIEGO 43 BRNO 17899651365255042855774128,32,-5423.00
2015-12-26,PRZELEW UZNANIOWY (NADANO 26-12-2015) SK£ADKA CZ£ONKOWSKA ZA MIESI¥C 12-2015  MICHA£ WARSZAWSKI  WOJSKA CZESKIEGO 43 BRNO 23443802999365338920635066,32,-5455.00
2015-12-26,PRZELEW UZNANIOWY (NADANO 26-12-2015) SK£ADKA CZ£ONKOWSKA ZA MIESI¥C 12-2015  PAWE£ NOWAK  WOJSKA CZESKIEGO 43 BRNO 51811981846136092315691250,64,-5519.00
2015-12-28,PRZELEW UZNANIOWY (NADANO 28-12-2015) SK£ADKA CZ£ONKOWSKA ZA MIESI¥C 12-2015  HENRYK KOWALSKI  WOJSKA CZESKIEGO 43 BRNO 75941382584253619600980534,64,-5583.00
2015-12-30,PRZELEW UZNANIOWY (NADANO 30-12-2015) DAROWIZNA  MAREK OWCZAREK  WOJSKA CZESKIEGO 43 BRNO 53425850952111828232111196,751,-6334.00
2015-12-31,PRZELEW UZNANIOWY (NADANO 31-12-2015) SK£ADKA CZ£ONKOWSKA ZA MIESI¥C 12-2015  STANIS£AW CZARNOWSKI  WOJSKA CZESKIEGO 43 BRNO 35360183439905088132995770,128,-6462.00
2016-01-01,PRZELEW UZNANIOWY (NADANO 01-01-2016) SK£ADKA CZ£ONKOWSKA ZA MIESI¥C 01-2016  DAWID NOWAK  WOJSKA CZESKIEGO 43 BRNO 29674271118890170434752331,32,-6494.00
2016-01-02,PRZELEW UZNANIOWY (NADANO 02-01-2016) SK£ADKA CZ£ONKOWSKA ZA MIESI¥C 01-2016  £UKASZ WARSZAWSKI  WOJSKA CZESKIEGO 43 BRNO 39471817344336404091411046,32,-6526.00
2016-01-02,PRZELEW OBCI¥¯ENIOWY (NADANO 02-01-2016) COS DO PLACENIA  UPC  WOJSKA CZESKIEGO 43 BRNO 69119814079990953318494866,-331,-6195.00
2016-01-03,PRZELEW UZNANIOWY (NADANO 03-01-2016) SK£ADKA CZ£ONKOWSKA ZA MIESI¥C 01-2016  PAWE£ KOWALSKI  WOJSKA CZESKIEGO 43 BRNO 43214222011334215144665427,32,-6227.00
2016-01-04,PRZELEW UZNANIOWY (NADANO 04-01-2016) SK£ADKA CZ£ONKOWSKA ZA MIESI¥C 01-2016  MICHA£ WARSZAWSKI  WOJSKA CZESKIEGO 43 BRNO 14330355842344297555285804,64,-6291.00
2016-01-04,PRZELEW UZNANIOWY (NADANO 04-01-2016) SK£ADKA CZ£ONKOWSKA ZA MIESI¥C 01-2016  STANIS£AW CZARNOWSKI  WOJSKA CZESKIEGO 43 BRNO 17192281072963141575624828,16,-6307.00
2016-01-04,PRZELEW UZNANIOWY (NADANO 04-01-2016) SK£ADKA CZ£ONKOWSKA ZA MIESI¥C 01-2016  £UKASZ NOWAK  WOJSKA CZESKIEGO 43 BRNO 69141896290514466085121176,64,-6371.00
2016-01-04,PRZELEW UZNANIOWY (NADANO 04-01-2016) SK£ADKA CZ£ONKOWSKA ZA MIESI¥C 01-2016  STANIS£AW STAROWSKI  WOJSKA CZESKIEGO 43 BRNO 36730993359910852933950649,128,-6499.00
2016-01-06,PRZELEW UZNANIOWY (NADANO 06-01-2016) SK£ADKA CZ£ONKOWSKA ZA MIESI¥C 01-2016  MAREK TESTOWSKI  WOJSKA CZESKIEGO 43 BRNO 33092458471344636692380009,128,-6627.00
2016-01-06,PRZELEW UZNANIOWY (NADANO 06-01-2016) SK£ADKA CZ£ONKOWSKA ZA MIESI¥C 01-2016  STANIS£AW MARKOWSKI  WOJSKA CZESKIEGO 43 BRNO 58715211305568443928045739,128,-6755.00
2016-01-07,PRZELEW UZNANIOWY (NADANO 07-01-2016) SK£ADKA CZ£ONKOWSKA ZA MIESI¥C 01-2016  MAREK NOWAK  WOJSKA CZESKIEGO 43 BRNO 92464308568484987648295085,64,-6819.00
2016-01-09,PRZELEW UZNANIOWY (NADANO 09-01-2016) SK£ADKA CZ£ONKOWSKA ZA MIESI¥C 01-2016  PAWE£ KOWALSKI  WOJSKA CZESKIEGO 43 BRNO 47775426660979722007742553,16,-6835.00
2016-01-11,PRZELEW UZNANIOWY (NADANO 11-01-2016) SK£ADKA CZ£ONKOWSKA ZA MIESI¥C 01-2016  STANIS£AW MARKOWSKI  WOJSKA CZESKIEGO 43 BRNO 21653291501022189080505341,128,-6963.00
2016-01-11,PRZELEW UZNANIOWY (NADANO 11-01-2016) SK£ADKA CZ£ONKOWSKA ZA MIESI¥C 01-2016  MICHA£ WARSZAWSKI  WOJSKA CZESKIEGO 43 BRNO 36635777833927002797401942,64,-7027.00
2016-01-11,PRZELEW UZNANIOWY (NADANO 11-01-2016) SK£ADKA CZ£ONKOWSKA ZA MIESI¥C 01-2016  STANIS£AW MARKOWSKI  WOJSKA CZESKIEGO 43 BRNO 74763065662077538307742054,16,-7043.00
2016-01-12,PRZELEW UZNANIOWY (NADANO 12-01-2016) DAROWIZNA  HENRYK CHOLERAWIECKI  WOJSKA CZESKIEGO 43 BRNO 35268611397218295918873540,407,-7450.00
2016-01-13,PRZELEW UZNANIOWY (NADANO 13-01-2016) SK£ADKA CZ£ONKOWSKA ZA MIESI¥C 01-2016  STANIS£AW STAROWSKI  WOJSKA CZESKIEGO 43 BRNO 68982113575386365430998399,64,-7514.00
2016-01-15,PRZELEW UZNANIOWY (NADANO 15-01-2016) DAROWIZNA  DAREK NOWAK  WOJSKA CZESKIEGO 43 BRNO 21133317708688019566500352,820,-8334.00
2016-01-16,PRZELEW UZNANIOWY (NADANO 16-01-2016) SK£ADKA CZ£ONKOWSKA ZA MIESI¥C 01-2016  OKTAWIAN RYBSKI  WOJSKA CZESKIEGO 43 BRNO 18964435006451354384439207,64,-8398.00
2016-01-18,PRZELEW UZNANIOWY (NADANO 18-01-2016) SK£ADKA CZ£ONKOWSKA ZA MIESI¥C 01-2016  OKTAWIAN PROSTACKI  WOJSKA CZESKIEGO 43 BRNO 11150177128554090722604370,64,-8462.00
2016-01-20,PRZELEW UZNANIOWY (NADANO 20-01-2016) SK£ADKA CZ£ONKOWSKA ZA MIESI¥C 01-2016  PAWE£ KOWALSKI  WOJSKA CZESKIEGO 43 BRNO 70340413976423005251816237,64,-8526.00
2016-01-20,PRZELEW UZNANIOWY (NADANO 20-01-2016) SK£ADKA CZ£ONKOWSKA ZA MIESI¥C 01-2016  OKTAWIAN NOWAK  WOJSKA CZESKIEGO 43 BRNO 98340943844919262800835142,64,-8590.00
2016-01-20,PRZELEW UZNANIOWY (NADANO 20-01-2016) SK£ADKA CZ£ONKOWSKA ZA MIESI¥C 01-2016  OKTAWIAN PROSTACKI  WOJSKA CZESKIEGO 43 BRNO 65391333116217203047179896,64,-8654.00
2016-01-22,PRZELEW UZNANIOWY (NADANO 22-01-2016) SK£ADKA CZ£ONKOWSKA ZA MIESI¥C 01-2016  OKTAWIAN RYBSKI  WOJSKA CZESKIEGO 43 BRNO 86298428465841924776482515,32,-8686.00
2016-01-22,PRZELEW UZNANIOWY (NADANO 22-01-2016) SK£ADKA CZ£ONKOWSKA ZA MIESI¥C 01-2016  HENRYK KOWALSKI  WOJSKA CZESKIEGO 43 BRNO 46302673361903432289286064,128,-8814.00
2016-01-24,PRZELEW UZNANIOWY (NADANO 24-01-2016) SK£ADKA CZ£ONKOWSKA ZA MIESI¥C 01-2016  STANIS£AW STAROWSKI  WOJSKA CZESKIEGO 43 BRNO 96278200892545912017573049,32,-8846.00
2016-01-25,PRZELEW UZNANIOWY (NADANO 25-01-2016) SK£ADKA CZ£ONKOWSKA ZA MIESI¥C 01-2016  MICHA£ CZARNOWSKI  WOJSKA CZESKIEGO 43 BRNO 32174444784436713168474782,16,-8862.00
2016-01-27,PRZELEW UZNANIOWY (NADANO 27-01-2016) SK£ADKA CZ£ONKOWSKA ZA MIESI¥C 01-2016  BARTUŒ CZARNOWSKI  WOJSKA CZESKIEGO 43 BRNO 67093615614166908161000666,128,-8990.00
2016-01-29,PRZELEW UZNANIOWY (NADANO 29-01-2016) SK£ADKA CZ£ONKOWSKA ZA MIESI¥C 01-2016  STANIS£AW STAROWSKI  WOJSKA CZESKIEGO 43 BRNO 44765434536756838027117691,32,-9022.00
2016-01-29,PRZELEW UZNANIOWY (NADANO 29-01-2016) SK£ADKA CZ£ONKOWSKA ZA MIESI¥C 01-2016  BARTUŒ NOWAK  WOJSKA CZESKIEGO 43 BRNO 56037204874375660039158806,32,-9054.00
2016-01-29,PRZELEW UZNANIOWY (NADANO 29-01-2016) DAROWIZNA  HENRYK CHOLERAWIECKI  WOJSKA CZESKIEGO 43 BRNO 73476126321758346733258198,1013,-10067.00
2016-01-29,PRZELEW UZNANIOWY (NADANO 29-01-2016) SK£ADKA CZ£ONKOWSKA ZA MIESI¥C 01-2016  £UKASZ WARSZAWSKI  WOJSKA CZESKIEGO 43 BRNO 16329402099419056588594226,16,-10083.00
2016-01-30,PRZELEW UZNANIOWY (NADANO 30-01-2016) DAROWIZNA  DAWID NOWAK  WOJSKA CZESKIEGO 43 BRNO 06003214131665438109660869,763,-10846.00
2016-02-01,PRZELEW UZNANIOWY (NADANO 01-02-2016) SK£ADKA CZ£ONKOWSKA ZA MIESI¥C 02-2016  BARTUŒ NOWAK  WOJSKA CZESKIEGO 43 BRNO 72776585952158360669759128,128,-10974.00
2016-02-02,PRZELEW UZNANIOWY (NADANO 02-02-2016) DAROWIZNA  MAREK CZARNOWSKI  WOJSKA CZESKIEGO 43 BRNO 02711414528666375208299230,816,-11790.00
2016-02-04,PRZELEW UZNANIOWY (NADANO 04-02-2016) SK£ADKA CZ£ONKOWSKA ZA MIESI¥C 02-2016  DAWID MARKOWSKI  WOJSKA CZESKIEGO 43 BRNO 44895328284052393286768509,128,-11918.00
2016-02-05,PRZELEW UZNANIOWY (NADANO 05-02-2016) DAROWIZNA  OKTAWIAN NOWAK  WOJSKA CZESKIEGO 43 BRNO 88593788159821910292142694,920,-12838.00
2016-02-07,PRZELEW UZNANIOWY (NADANO 07-02-2016) SK£ADKA CZ£ONKOWSKA ZA MIESI¥C 02-2016  OKTAWIAN PROSTACKI  WOJSKA CZESKIEGO 43 BRNO 38343078921157212234976207,32,-12870.00
2016-02-09,PRZELEW UZNANIOWY (NADANO 09-02-2016) SK£ADKA CZ£ONKOWSKA ZA MIESI¥C 02-2016  £UKASZ STAROWSKI  WOJSKA CZESKIEGO 43 BRNO 08462781690579766526593089,128,-12998.00
2016-02-11,PRZELEW OBCI¥¯ENIOWY (NADANO 11-02-2016) COS DO PLACENIA  LOKAL  WOJSKA CZESKIEGO 43 BRNO 45306894102512178324602644,-945,-12053.00
2016-02-11,PRZELEW UZNANIOWY (NADANO 11-02-2016) SK£ADKA CZ£ONKOWSKA ZA MIESI¥C 02-2016  PAWE£ KOWALSKI  WOJSKA CZESKIEGO 43 BRNO 95484637402595730780294635,16,-12069.00
2016-02-12,PRZELEW UZNANIOWY (NADANO 12-02-2016) SK£ADKA CZ£ONKOWSKA ZA MIESI¥C 02-2016  HENRYK KOWALSKI  WOJSKA CZESKIEGO 43 BRNO 54719390569544827630163541,16,-12085.00
2016-02-14,PRZELEW UZNANIOWY (NADANO 14-02-2016) SK£ADKA CZ£ONKOWSKA ZA MIESI¥C 02-2016  PAWE£ NOWAK  WOJSKA CZESKIEGO 43 BRNO 76359420184362932582891715,128,-12213.00
2016-02-16,PRZELEW UZNANIOWY (NADANO 16-02-2016) SK£ADKA CZ£ONKOWSKA ZA MIESI¥C 02-2016  HENRYK KOWALSKI  WOJSKA CZESKIEGO 43 BRNO 59258210049045887508373652,128,-12341.00
2016-02-16,PRZELEW UZNANIOWY (NADANO 16-02-2016) SK£ADKA CZ£ONKOWSKA ZA MIESI¥C 02-2016  DAREK NOWAK  WOJSKA CZESKIEGO 43 BRNO 21073469486487089880501352,64,-12405.00
2016-02-16,PRZELEW OBCI¥¯ENIOWY (NADANO 16-02-2016) COS DO PLACENIA  UPC  WOJSKA CZESKIEGO 43 BRNO 32413780707782752391115675,-659,-11746.00
2016-02-16,PRZELEW UZNANIOWY (NADANO 16-02-2016) DAROWIZNA  STANIS£AW CZARNOWSKI  WOJSKA CZESKIEGO 43 BRNO 02213883082849897068686350,638,-12384.00
2016-02-17,PRZELEW UZNANIOWY (NADANO 17-02-2016) SK£ADKA CZ£ONKOWSKA ZA MIESI¥C 02-2016  MAREK CZARNOWSKI  WOJSKA CZESKIEGO 43 BRNO 65530872220122256200525593,64,-12448.00
2016-02-18,PRZELEW UZNANIOWY (NADANO 18-02-2016) SK£ADKA CZ£ONKOWSKA ZA MIESI¥C 02-2016  STANIS£AW WARSZAWSKI  WOJSKA CZESKIEGO 43 BRNO 60507662379781566460864269,128,-12576.00
2016-02-20,PRZELEW UZNANIOWY (NADANO 20-02-2016) SK£ADKA CZ£ONKOWSKA ZA MIESI¥C 02-2016  STANIS£AW STAROWSKI  WOJSKA CZESKIEGO 43 BRNO 98145026625862246871056751,128,-12704.00
2016-02-20,PRZELEW UZNANIOWY (NADANO 20-02-2016) SK£ADKA CZ£ONKOWSKA ZA MIESI¥C 02-2016  MICHA£ CZARNOWSKI  WOJSKA CZESKIEGO 43 BRNO 81631486144669104499243533,32,-12736.00
2016-02-22,PRZELEW UZNANIOWY (NADANO 22-02-2016) DAROWIZNA  BARTUŒ TESTOWSKI  WOJSKA CZESKIEGO 43 BRNO 09513832851129959073195330,577,-13313.00
2016-02-22,PRZELEW UZNANIOWY (NADANO 22-02-2016) SK£ADKA CZ£ONKOWSKA ZA MIESI¥C 02-2016  STANIS£AW STAROWSKI  WOJSKA CZESKIEGO 43 BRNO 80460277321946542114628521,16,-13329.00
2016-02-24,PRZELEW UZNANIOWY (NADANO 24-02-2016) SK£ADKA CZ£ONKOWSKA ZA MIESI¥C 02-2016  MAREK NOWAK  WOJSKA CZESKIEGO 43 BRNO 98287574376080247301141733,16,-13345.00
2016-02-25,PRZELEW UZNANIOWY (NADANO 25-02-2016) SK£ADKA CZ£ONKOWSKA ZA MIESI¥C 02-2016  £UKASZ STAROWSKI  WOJSKA CZESKIEGO 43 BRNO 38214828035635096032623120,128,-13473.00
2016-02-25,PRZELEW UZNANIOWY (NADANO 25-02-2016) SK£ADKA CZ£ONKOWSKA ZA MIESI¥C 02-2016  STANIS£AW OWCZAREK  WOJSKA CZESKIEGO 43 BRNO 09110312215482897408023556,16,-13489.00
2016-02-27,PRZELEW UZNANIOWY (NADANO 27-02-2016) SK£ADKA CZ£ONKOWSKA ZA MIESI¥C 02-2016  £UKASZ STAROWSKI  WOJSKA CZESKIEGO 43 BRNO 71090235311974590940422927,16,-13505.00
2016-02-27,PRZELEW UZNANIOWY (NADANO 27-02-2016) SK£ADKA CZ£ONKOWSKA ZA MIESI¥C 02-2016  DAWID RYBSKI  WOJSKA CZESKIEGO 43 BRNO 06576030902873590259034659,128,-13633.00
2016-02-29,PRZELEW UZNANIOWY (NADANO 29-02-2016) SK£ADKA CZ£ONKOWSKA ZA MIESI¥C 02-2016  HENRYK KOWALSKI  WOJSKA CZESKIEGO 43 BRNO 96258017520901268206667085,16,-13649.00
2016-03-02,PRZELEW UZNANIOWY (NADANO 02-03-2016) SK£ADKA CZ£ONKOWSKA ZA MIESI¥C 03-2016  OKTAWIAN NOWAK  WOJSKA CZESKIEGO 43 BRNO 14073298783091776123010672,32,-13681.00
2016-03-02,PRZELEW UZNANIOWY (NADANO 02-03-2016) SK£ADKA CZ£ONKOWSKA ZA MIESI¥C 03-2016  OKTAWIAN RYBSKI  WOJSKA CZESKIEGO 43 BRNO 15088236024725117033729173,32,-13713.00
2016-03-03,PRZELEW UZNANIOWY (NADANO 03-03-2016) SK£ADKA CZ£ONKOWSKA ZA MIESI¥C 03-2016  BARTUŒ CZARNOWSKI  WOJSKA CZESKIEGO 43 BRNO 29605300199812576104702723,16,-13729.00
2016-03-04,PRZELEW UZNANIOWY (NADANO 04-03-2016) SK£ADKA CZ£ONKOWSKA ZA MIESI¥C 03-2016  MICHA£ KOWALSKI  WOJSKA CZESKIEGO 43 BRNO 48888827996804225104564162,16,-13745.00
2016-03-05,PRZELEW UZNANIOWY (NADANO 05-03-2016) SK£ADKA CZ£ONKOWSKA ZA MIESI¥C 03-2016  STANIS£AW CZARNOWSKI  WOJSKA CZESKIEGO 43 BRNO 67985445791680242894782181,64,-13809.00
2016-03-05,PRZELEW UZNANIOWY (NADANO 05-03-2016) SK£ADKA CZ£ONKOWSKA ZA MIESI¥C 03-2016  BARTUŒ CZARNOWSKI  WOJSKA CZESKIEGO 43 BRNO 03542273574588680539357680,64,-13873.00
2016-03-05,PRZELEW UZNANIOWY (NADANO 05-03-2016) SK£ADKA CZ£ONKOWSKA ZA MIESI¥C 03-2016  HENRYK KOWALSKI  WOJSKA CZESKIEGO 43 BRNO 89568583315453521870467638,16,-13889.00
2016-03-07,PRZELEW OBCI¥¯ENIOWY (NADANO 07-03-2016) COS DO PLACENIA  LOKAL  WOJSKA CZESKIEGO 43 BRNO 78653420764044546551242565,-757,-13132.00
2016-03-07,PRZELEW UZNANIOWY (NADANO 07-03-2016) DAROWIZNA  STANIS£AW OWCZAREK  WOJSKA CZESKIEGO 43 BRNO 17007869386236359712818267,429,-13561.00
2016-03-07,PRZELEW UZNANIOWY (NADANO 07-03-2016) SK£ADKA CZ£ONKOWSKA ZA MIESI¥C 03-2016  BARTUŒ CZARNOWSKI  WOJSKA CZESKIEGO 43 BRNO 21494300853322901163313499,16,-13577.00
2016-03-08,PRZELEW OBCI¥¯ENIOWY (NADANO 08-03-2016) COS DO PLACENIA  UPC  WOJSKA CZESKIEGO 43 BRNO 28117568079342613829074200,-764,-12813.00
2016-03-08,PRZELEW UZNANIOWY (NADANO 08-03-2016) SK£ADKA CZ£ONKOWSKA ZA MIESI¥C 03-2016  MAREK NOWAK  WOJSKA CZESKIEGO 43 BRNO 12000608946492451927738623,128,-12941.00
2016-03-08,PRZELEW OBCI¥¯ENIOWY (NADANO 08-03-2016) COS DO PLACENIA  TAURON  WOJSKA CZESKIEGO 43 BRNO 05789128200881847104889271,-639,-12302.00
2016-03-09,PRZELEW UZNANIOWY (NADANO 09-03-2016) SK£ADKA CZ£ONKOWSKA ZA MIESI¥C 03-2016  BARTUŒ CZARNOWSKI  WOJSKA CZESKIEGO 43 BRNO 18779580132355029322121935,128,-12430.00
2016-03-09,PRZELEW UZNANIOWY (NADANO 09-03-2016) SK£ADKA CZ£ONKOWSKA ZA MIESI¥C 03-2016  STANIS£AW CZARNOWSKI  WOJSKA CZESKIEGO 43 BRNO 75109929930488355440863534,128,-12558.00
2016-03-09,PRZELEW UZNANIOWY (NADANO 09-03-2016) SK£ADKA CZ£ONKOWSKA ZA MIESI¥C 03-2016  £UKASZ WARSZAWSKI  WOJSKA CZESKIEGO 43 BRNO 53125885653448566939378864,16,-12574.00
2016-03-09,PRZELEW UZNANIOWY (NADANO 09-03-2016) SK£ADKA CZ£ONKOWSKA ZA MIESI¥C 03-2016  STANIS£AW STAROWSKI  WOJSKA CZESKIEGO 43 BRNO 27225814279463943270928166,16,-12590.00
2016-03-11,PRZELEW UZNANIOWY (NADANO 11-03-2016) DAROWIZNA  DAWID NOWAK  WOJSKA CZESKIEGO 43 BRNO 40567381551621618905800097,766,-13356.00
2016-03-12,PRZELEW UZNANIOWY (NADANO 12-03-2016) SK£ADKA CZ£ONKOWSKA ZA MIESI¥C 03-2016  MICHA£ KOWALSKI  WOJSKA CZESKIEGO 43 BRNO 14389869606972270134025304,32,-13388.00
2016-03-13,PRZELEW UZNANIOWY (NADANO 13-03-2016) SK£ADKA CZ£ONKOWSKA ZA MIESI¥C 03-2016  MICHA£ CZARNOWSKI  WOJSKA CZESKIEGO 43 BRNO 61635872805101414218696147,64,-13452.00
2016-03-15,PRZELEW UZNANIOWY (NADANO 15-03-2016) SK£ADKA CZ£ONKOWSKA ZA MIESI¥C 03-2016  STANIS£AW MARKOWSKI  WOJSKA CZESKIEGO 43 BRNO 36146136037573397376122097,32,-13484.00
2016-03-16,PRZELEW UZNANIOWY (NADANO 16-03-2016) SK£ADKA CZ£ONKOWSKA ZA MIESI¥C 03-2016  DAREK NOWAK  WOJSKA CZESKIEGO 43 BRNO 80673901831986205013783064,32,-13516.00
2016-03-16,PRZELEW UZNANIOWY (NADANO 16-03-2016) SK£ADKA CZ£ONKOWSKA ZA MIESI¥C 03-2016  OKTAWIAN RYBSKI  WOJSKA CZESKIEGO 43 BRNO 64327564901907329492014874,32,-13548.00
2016-03-18,PRZELEW UZNANIOWY (NADANO 18-03-2016) SK£ADKA CZ£ONKOWSKA ZA MIESI¥C 03-2016  MAREK TESTOWSKI  WOJSKA CZESKIEGO 43 BRNO 49366377559060806314717470,64,-13612.00
2016-03-19,PRZELEW OBCI¥¯ENIOWY (NADANO 19-03-2016) COS DO PLACENIA  LOKAL  WOJSKA CZESKIEGO 43 BRNO 58852407170981292056712035,-454,-13158.00
2016-03-21,PRZELEW UZNANIOWY (NADANO 21-03-2016) SK£ADKA CZ£ONKOWSKA ZA MIESI¥C 03-2016  MAREK TESTOWSKI  WOJSKA CZESKIEGO 43 BRNO 91548675901003039035592332,32,-13190.00
2016-03-22,PRZELEW OBCI¥¯ENIOWY (NADANO 22-03-2016) COS DO PLACENIA  UPC  WOJSKA CZESKIEGO 43 BRNO 28134291611307054954901504,-335,-12855.00
2016-03-24,PRZELEW UZNANIOWY (NADANO 24-03-2016) SK£ADKA CZ£ONKOWSKA ZA MIESI¥C 03-2016  HENRYK KOWALSKI  WOJSKA CZESKIEGO 43 BRNO 62698649497434350169207086,16,-12871.00
2016-03-25,PRZELEW UZNANIOWY (NADANO 25-03-2016) SK£ADKA CZ£ONKOWSKA ZA MIESI¥C 03-2016  PAWE£ KOWALSKI  WOJSKA CZESKIEGO 43 BRNO 38432579545631948530492220,32,-12903.00
2016-03-27,PRZELEW UZNANIOWY (NADANO 27-03-2016) SK£ADKA CZ£ONKOWSKA ZA MIESI¥C 03-2016  HENRYK KOWALSKI  WOJSKA CZESKIEGO 43 BRNO 02762478467313223146290445,128,-13031.00
2016-03-27,PRZELEW UZNANIOWY (NADANO 27-03-2016) SK£ADKA CZ£ONKOWSKA ZA MIESI¥C 03-2016  OKTAWIAN NOWAK  WOJSKA CZESKIEGO 43 BRNO 04803810022156589179329244,32,-13063.00
2016-03-28,PRZELEW UZNANIOWY (NADANO 28-03-2016) SK£ADKA CZ£ONKOWSKA ZA MIESI¥C 03-2016  MAREK OWCZAREK  WOJSKA CZESKIEGO 43 BRNO 55408198217143117562597070,64,-13127.00
2016-03-30,PRZELEW UZNANIOWY (NADANO 30-03-2016) DAROWIZNA  MAREK CZARNOWSKI  WOJSKA CZESKIEGO 43 BRNO 42900804988024609828842917,395,-13522.00
2016-03-31,PRZELEW UZNANIOWY (NADANO 31-03-2016) SK£ADKA CZ£ONKOWSKA ZA MIESI¥C 03-2016  £UKASZ WARSZAWSKI  WOJSKA CZESKIEGO 43 BRNO 44913863828782241249260777,128,-13650.00
2016-03-31,PRZELEW UZNANIOWY (NADANO 31-03-2016) SK£ADKA CZ£ONKOWSKA ZA MIESI¥C 03-2016  DAREK NOWAK  WOJSKA CZESKIEGO 43 BRNO 01565815571525640171304012,16,-13666.00
2016-03-31,PRZELEW UZNANIOWY (NADANO 31-03-2016) SK£ADKA CZ£ONKOWSKA ZA MIESI¥C 03-2016  STANIS£AW OWCZAREK  WOJSKA CZESKIEGO 43 BRNO 00522866619730985176926687,128,-13794.00
2016-04-02,PRZELEW UZNANIOWY (NADANO 02-04-2016) SK£ADKA CZ£ONKOWSKA ZA MIESI¥C 04-2016  MAREK CZARNOWSKI  WOJSKA CZESKIEGO 43 BRNO 40408742265052639550455903,128,-13922.00
2016-04-04,PRZELEW UZNANIOWY (NADANO 04-04-2016) DAROWIZNA  MAREK CZARNOWSKI  WOJSKA CZESKIEGO 43 BRNO 66793448430824065497104433,643,-14565.00
2016-04-06,PRZELEW UZNANIOWY (NADANO 06-04-2016) SK£ADKA CZ£ONKOWSKA ZA MIESI¥C 04-2016  OKTAWIAN NOWAK  WOJSKA CZESKIEGO 43 BRNO 63900773996105790863198522,32,-14597.00
2016-04-06,PRZELEW UZNANIOWY (NADANO 06-04-2016) SK£ADKA CZ£ONKOWSKA ZA MIESI¥C 04-2016  BARTUŒ CZARNOWSKI  WOJSKA CZESKIEGO 43 BRNO 21053654144052270952492719,32,-14629.00
2016-04-06,PRZELEW UZNANIOWY (NADANO 06-04-2016) SK£ADKA CZ£ONKOWSKA ZA MIESI¥C 04-2016  BARTUŒ NOWAK  WOJSKA CZESKIEGO 43 BRNO 86730070668889936657087076,128,-14757.00
2016-04-08,PRZELEW UZNANIOWY (NADANO 08-04-2016) SK£ADKA CZ£ONKOWSKA ZA MIESI¥C 04-2016  DAWID NOWAK  WOJSKA CZESKIEGO 43 BRNO 62892327778937092301759567,32,-14789.00
2016-04-08,PRZELEW UZNANIOWY (NADANO 08-04-2016) SK£ADKA CZ£ONKOWSKA ZA MIESI¥C 04-2016  STANIS£AW CZARNOWSKI  WOJSKA CZESKIEGO 43 BRNO 62805193526893020455285203,64,-14853.00
2016-04-08,PRZELEW UZNANIOWY (NADANO 08-04-2016) SK£ADKA CZ£ONKOWSKA ZA MIESI¥C 04-2016  OKTAWIAN PROSTACKI  WOJSKA CZESKIEGO 43 BRNO 37856289411667840944448328,64,-14917.00
2016-04-08,PRZELEW UZNANIOWY (NADANO 08-04-2016) SK£ADKA CZ£ONKOWSKA ZA MIESI¥C 04-2016  BARTUŒ TESTOWSKI  WOJSKA CZESKIEGO 43 BRNO 75353764445575113866755475,16,-14933.00
2016-04-09,PRZELEW UZNANIOWY (NADANO 09-04-2016) SK£ADKA CZ£ONKOWSKA ZA MIESI¥C 04-2016  MICHA£ KOWALSKI  WOJSKA CZESKIEGO 43 BRNO 22002397512714296065894751,128,-15061.00
2016-04-10,PRZELEW UZNANIOWY (NADANO 10-04-2016) SK£ADKA CZ£ONKOWSKA ZA MIESI¥C 04-2016  MICHA£ CZARNOWSKI  WOJSKA CZESKIEGO 43 BRNO 52553525834821870768718265,128,-15189.00
2016-04-10,PRZELEW UZNANIOWY (NADANO 10-04-2016) DAROWIZNA  MAREK NOWAK  WOJSKA CZESKIEGO 43 BRNO 60600003997579956873708213,741,-15930.00
2016-04-11,PRZELEW UZNANIOWY (NADANO 11-04-2016) DAROWIZNA  MAREK CZARNOWSKI  WOJSKA CZESKIEGO 43 BRNO 63466147989965826803842723,970,-16900.00
2016-04-13,PRZELEW UZNANIOWY (NADANO 13-04-2016) SK£ADKA CZ£ONKOWSKA ZA MIESI¥C 04-2016  MAREK CZARNOWSKI  WOJSKA CZESKIEGO 43 BRNO 17167993995733703938351704,128,-17028.00
2016-04-14,PRZELEW OBCI¥¯ENIOWY (NADANO 14-04-2016) COS DO PLACENIA  LOKAL  WOJSKA CZESKIEGO 43 BRNO 35956378521899228663179076,-288,-16740.00
2016-04-14,PRZELEW UZNANIOWY (NADANO 14-04-2016) SK£ADKA CZ£ONKOWSKA ZA MIESI¥C 04-2016  DAREK NOWAK  WOJSKA CZESKIEGO 43 BRNO 84710719571068388849748432,64,-16804.00
2016-04-14,PRZELEW UZNANIOWY (NADANO 14-04-2016) SK£ADKA CZ£ONKOWSKA ZA MIESI¥C 04-2016  BARTUŒ TESTOWSKI  WOJSKA CZESKIEGO 43 BRNO 70593074978509046316311707,32,-16836.00
2016-04-15,PRZELEW UZNANIOWY (NADANO 15-04-2016) SK£ADKA CZ£ONKOWSKA ZA MIESI¥C 04-2016  OKTAWIAN PROSTACKI  WOJSKA CZESKIEGO 43 BRNO 49865963526979508709559298,128,-16964.00
2016-04-15,PRZELEW UZNANIOWY (NADANO 15-04-2016) DAROWIZNA  MAREK TESTOWSKI  WOJSKA CZESKIEGO 43 BRNO 31467049574072490130639879,1013,-17977.00
2016-04-15,PRZELEW UZNANIOWY (NADANO 15-04-2016) SK£ADKA CZ£ONKOWSKA ZA MIESI¥C 04-2016  MAREK STAROWSKI  WOJSKA CZESKIEGO 43 BRNO 78924524694271011324367738,128,-18105.00
2016-04-17,PRZELEW UZNANIOWY (NADANO 17-04-2016) SK£ADKA CZ£ONKOWSKA ZA MIESI¥C 04-2016  HENRYK CHOLERAWIECKI  WOJSKA CZESKIEGO 43 BRNO 98934934433300164290449010,32,-18137.00
2016-04-18,PRZELEW UZNANIOWY (NADANO 18-04-2016) SK£ADKA CZ£ONKOWSKA ZA MIESI¥C 04-2016  STANIS£AW MARKOWSKI  WOJSKA CZESKIEGO 43 BRNO 37997761651092502799839551,16,-18153.00
2016-04-19,PRZELEW UZNANIOWY (NADANO 19-04-2016) SK£ADKA CZ£ONKOWSKA ZA MIESI¥C 04-2016  STANIS£AW CZARNOWSKI  WOJSKA CZESKIEGO 43 BRNO 71444632559747248255235571,16,-18169.00
2016-04-19,PRZELEW UZNANIOWY (NADANO 19-04-2016) SK£ADKA CZ£ONKOWSKA ZA MIESI¥C 04-2016  MICHA£ KOWALSKI  WOJSKA CZESKIEGO 43 BRNO 37718738255442880346782727,32,-18201.00
2016-04-21,PRZELEW UZNANIOWY (NADANO 21-04-2016) SK£ADKA CZ£ONKOWSKA ZA MIESI¥C 04-2016  STANIS£AW WARSZAWSKI  WOJSKA CZESKIEGO 43 BRNO 39888290185319068586389157,16,-18217.00
2016-04-21,PRZELEW UZNANIOWY (NADANO 21-04-2016) SK£ADKA CZ£ONKOWSKA ZA MIESI¥C 04-2016  DAWID MARKOWSKI  WOJSKA CZESKIEGO 43 BRNO 95990512690139330597880194,128,-18345.00
2016-04-21,PRZELEW UZNANIOWY (NADANO 21-04-2016) SK£ADKA CZ£ONKOWSKA ZA MIESI¥C 04-2016  £UKASZ STAROWSKI  WOJSKA CZESKIEGO 43 BRNO 62403904877357116408214720,32,-18377.00
2016-04-22,PRZELEW UZNANIOWY (NADANO 22-04-2016) SK£ADKA CZ£ONKOWSKA ZA MIESI¥C 04-2016  HENRYK CHOLERAWIECKI  WOJSKA CZESKIEGO 43 BRNO 37118800285533225158537413,16,-18393.00
2016-04-22,PRZELEW UZNANIOWY (NADANO 22-04-2016) SK£ADKA CZ£ONKOWSKA ZA MIESI¥C 04-2016  STANIS£AW MARKOWSKI  WOJSKA CZESKIEGO 43 BRNO 09100818709094164356345541,32,-18425.00
2016-04-24,PRZELEW UZNANIOWY (NADANO 24-04-2016) SK£ADKA CZ£ONKOWSKA ZA MIESI¥C 04-2016  STANIS£AW CZARNOWSKI  WOJSKA CZESKIEGO 43 BRNO 98806376143870808286530788,16,-18441.00
2016-04-26,PRZELEW UZNANIOWY (NADANO 26-04-2016) SK£ADKA CZ£ONKOWSKA ZA MIESI¥C 04-2016  STANIS£AW MARKOWSKI  WOJSKA CZESKIEGO 43 BRNO 11211606414240953027651142,16,-18457.00
2016-04-28,PRZELEW UZNANIOWY (NADANO 28-04-2016) SK£ADKA CZ£ONKOWSKA ZA MIESI¥C 04-2016  £UKASZ STAROWSKI  WOJSKA CZESKIEGO 43 BRNO 65887336869004020613411399,32,-18489.00
2016-04-28,PRZELEW UZNANIOWY (NADANO 28-04-2016) SK£ADKA CZ£ONKOWSKA ZA MIESI¥C 04-2016  OKTAWIAN PROSTACKI  WOJSKA CZESKIEGO 43 BRNO 89111607786109523348879344,128,-18617.00
2016-04-29,PRZELEW UZNANIOWY (NADANO 29-04-2016) SK£ADKA CZ£ONKOWSKA ZA MIESI¥C 04-2016  DAWID RYBSKI  WOJSKA CZESKIEGO 43 BRNO 01038054831290487230441099,16,-18633.00
2016-04-30,PRZELEW OBCI¥¯ENIOWY (NADANO 30-04-2016) COS DO PLACENIA  LOKAL  WOJSKA CZESKIEGO 43 BRNO 14783424219982651044423884,-962,-17671.00
2016-05-01,PRZELEW OBCI¥¯ENIOWY (NADANO 01-05-2016) COS DO PLACENIA  UPC  WOJSKA CZESKIEGO 43 BRNO 84119310956549719133783066,-975,-16696.00
2016-05-03,PRZELEW UZNANIOWY (NADANO 03-05-2016) SK£ADKA CZ£ONKOWSKA ZA MIESI¥C 05-2016  DAREK NOWAK  WOJSKA CZESKIEGO 43 BRNO 24515009482320690980487300,16,-16712.00
2016-05-03,PRZELEW OBCI¥¯ENIOWY (NADANO 03-05-2016) COS DO PLACENIA  UPC  WOJSKA CZESKIEGO 43 BRNO 65629498806676462735484726,-490,-16222.00
2016-05-04,PRZELEW UZNANIOWY (NADANO 04-05-2016) SK£ADKA CZ£ONKOWSKA ZA MIESI¥C 05-2016  OKTAWIAN PROSTACKI  WOJSKA CZESKIEGO 43 BRNO 73028378977372504778429971,128,-16350.00
2016-05-06,PRZELEW UZNANIOWY (NADANO 06-05-2016) SK£ADKA CZ£ONKOWSKA ZA MIESI¥C 05-2016  PAWE£ KOWALSKI  WOJSKA CZESKIEGO 43 BRNO 89342207246186214058745288,128,-16478.00
2016-05-06,PRZELEW UZNANIOWY (NADANO 06-05-2016) SK£ADKA CZ£ONKOWSKA ZA MIESI¥C 05-2016  £UKASZ NOWAK  WOJSKA CZESKIEGO 43 BRNO 89431907572309209982733899,32,-16510.00
2016-05-07,PRZELEW UZNANIOWY (NADANO 07-05-2016) SK£ADKA CZ£ONKOWSKA ZA MIESI¥C 05-2016  DAREK NOWAK  WOJSKA CZESKIEGO 43 BRNO 50261791367347765983330202,64,-16574.00
2016-05-09,PRZELEW UZNANIOWY (NADANO 09-05-2016) DAROWIZNA  STANIS£AW WARSZAWSKI  WOJSKA CZESKIEGO 43 BRNO 74769077477341461470318414,407,-16981.00
2016-05-09,PRZELEW UZNANIOWY (NADANO 09-05-2016) SK£ADKA CZ£ONKOWSKA ZA MIESI¥C 05-2016  STANIS£AW WARSZAWSKI  WOJSKA CZESKIEGO 43 BRNO 45504564613297571748300979,32,-17013.00
2016-05-11,PRZELEW UZNANIOWY (NADANO 11-05-2016) SK£ADKA CZ£ONKOWSKA ZA MIESI¥C 05-2016  DAWID MARKOWSKI  WOJSKA CZESKIEGO 43 BRNO 21312517319002366360566032,64,-17077.00
2016-05-11,PRZELEW UZNANIOWY (NADANO 11-05-2016) SK£ADKA CZ£ONKOWSKA ZA MIESI¥C 05-2016  DAWID NOWAK  WOJSKA CZESKIEGO 43 BRNO 02296858794905301534998829,128,-17205.00
2016-05-13,PRZELEW UZNANIOWY (NADANO 13-05-2016) SK£ADKA CZ£ONKOWSKA ZA MIESI¥C 05-2016  BARTUŒ TESTOWSKI  WOJSKA CZESKIEGO 43 BRNO 37546478834726973962851289,64,-17269.00
2016-05-14,PRZELEW UZNANIOWY (NADANO 14-05-2016) SK£ADKA CZ£ONKOWSKA ZA MIESI¥C 05-2016  STANIS£AW STAROWSKI  WOJSKA CZESKIEGO 43 BRNO 69801274148835628188614167,32,-17301.00
2016-05-14,PRZELEW UZNANIOWY (NADANO 14-05-2016) SK£ADKA CZ£ONKOWSKA ZA MIESI¥C 05-2016  BARTUŒ TESTOWSKI  WOJSKA CZESKIEGO 43 BRNO 78670916324046559816661460,128,-17429.00
2016-05-15,PRZELEW UZNANIOWY (NADANO 15-05-2016) SK£ADKA CZ£ONKOWSKA ZA MIESI¥C 05-2016  MAREK TESTOWSKI  WOJSKA CZESKIEGO 43 BRNO 29318424592578530290619673,64,-17493.00
2016-05-17,PRZELEW UZNANIOWY (NADANO 17-05-2016) SK£ADKA CZ£ONKOWSKA ZA MIESI¥C 05-2016  MAREK NOWAK  WOJSKA CZESKIEGO 43 BRNO 57667323832143008090963242,16,-17509.00
2016-05-19,PRZELEW UZNANIOWY (NADANO 19-05-2016) SK£ADKA CZ£ONKOWSKA ZA MIESI¥C 05-2016  MICHA£ CZARNOWSKI  WOJSKA CZESKIEGO 43 BRNO 19216451629395222441537448,128,-17637.00
2016-05-20,PRZELEW UZNANIOWY (NADANO 20-05-2016) SK£ADKA CZ£ONKOWSKA ZA MIESI¥C 05-2016  DAWID RYBSKI  WOJSKA CZESKIEGO 43 BRNO 87777987609904166368109935,128,-17765.00
2016-05-20,PRZELEW UZNANIOWY (NADANO 20-05-2016) SK£ADKA CZ£ONKOWSKA ZA MIESI¥C 05-2016  DAWID MARKOWSKI  WOJSKA CZESKIEGO 43 BRNO 22471656498296292985880874,64,-17829.00
2016-05-20,PRZELEW UZNANIOWY (NADANO 20-05-2016) SK£ADKA CZ£ONKOWSKA ZA MIESI¥C 05-2016  PAWE£ NOWAK  WOJSKA CZESKIEGO 43 BRNO 76359065259370195119349607,32,-17861.00
2016-05-21,PRZELEW UZNANIOWY (NADANO 21-05-2016) SK£ADKA CZ£ONKOWSKA ZA MIESI¥C 05-2016  HENRYK CHOLERAWIECKI  WOJSKA CZESKIEGO 43 BRNO 16997352426136430263353500,16,-17877.00
2016-05-22,PRZELEW OBCI¥¯ENIOWY (NADANO 22-05-2016) COS DO PLACENIA  LOKAL  WOJSKA CZESKIEGO 43 BRNO 13007155513940303060066367,-602,-17275.00
2016-05-22,PRZELEW UZNANIOWY (NADANO 22-05-2016) SK£ADKA CZ£ONKOWSKA ZA MIESI¥C 05-2016  MAREK OWCZAREK  WOJSKA CZESKIEGO 43 BRNO 25951679037133220744598614,128,-17403.00
2016-05-22,PRZELEW OBCI¥¯ENIOWY (NADANO 22-05-2016) COS DO PLACENIA  TAURON  WOJSKA CZESKIEGO 43 BRNO 57398992706988815754834755,-333,-17070.00
2016-05-24,PRZELEW UZNANIOWY (NADANO 24-05-2016) SK£ADKA CZ£ONKOWSKA ZA MIESI¥C 05-2016  HENRYK KOWALSKI  WOJSKA CZESKIEGO 43 BRNO 78417467729101464897992018,64,-17134.00
2016-05-26,PRZELEW OBCI¥¯ENIOWY (NADANO 26-05-2016) COS DO PLACENIA  UPC  WOJSKA CZESKIEGO 43 BRNO 00773108884897782475965870,-838,-16296.00
2016-05-28,PRZELEW UZNANIOWY (NADANO 28-05-2016) SK£ADKA CZ£ONKOWSKA ZA MIESI¥C 05-2016  MICHA£ KOWALSKI  WOJSKA CZESKIEGO 43 BRNO 84239531345224374425324816,64,-16360.00
2016-05-28,PRZELEW UZNANIOWY (NADANO 28-05-2016) SK£ADKA CZ£ONKOWSKA ZA MIESI¥C 05-2016  PAWE£ NOWAK  WOJSKA CZESKIEGO 43 BRNO 46550962760956453664856432,128,-16488.00
2016-05-29,PRZELEW UZNANIOWY (NADANO 29-05-2016) SK£ADKA CZ£ONKOWSKA ZA MIESI¥C 05-2016  MICHA£ CZARNOWSKI  WOJSKA CZESKIEGO 43 BRNO 99342207822875807084925386,64,-16552.00
2016-05-29,PRZELEW UZNANIOWY (NADANO 29-05-2016) SK£ADKA CZ£ONKOWSKA ZA MIESI¥C 05-2016  MAREK TESTOWSKI  WOJSKA CZESKIEGO 43 BRNO 09600844334326115271201148,64,-16616.00
2016-05-31,PRZELEW UZNANIOWY (NADANO 31-05-2016) SK£ADKA CZ£ONKOWSKA ZA MIESI¥C 05-2016  MICHA£ KOWALSKI  WOJSKA CZESKIEGO 43 BRNO 16702681871784448376971758,128,-16744.00
2016-06-01,PRZELEW OBCI¥¯ENIOWY (NADANO 01-06-2016) COS DO PLACENIA  UPC  WOJSKA CZESKIEGO 43 BRNO 44151530475057946897168862,-739,-16005.00
2016-06-02,PRZELEW UZNANIOWY (NADANO 02-06-2016) SK£ADKA CZ£ONKOWSKA ZA MIESI¥C 06-2016  MICHA£ WARSZAWSKI  WOJSKA CZESKIEGO 43 BRNO 21950800004027553191408029,32,-16037.00
2016-06-02,PRZELEW UZNANIOWY (NADANO 02-06-2016) DAROWIZNA  DAWID RYBSKI  WOJSKA CZESKIEGO 43 BRNO 19297818129797961381669564,861,-16898.00
2016-06-02,PRZELEW UZNANIOWY (NADANO 02-06-2016) SK£ADKA CZ£ONKOWSKA ZA MIESI¥C 06-2016  MAREK TESTOWSKI  WOJSKA CZESKIEGO 43 BRNO 06301589576357060325076708,16,-16914.00
2016-06-04,PRZELEW UZNANIOWY (NADANO 04-06-2016) SK£ADKA CZ£ONKOWSKA ZA MIESI¥C 06-2016  STANIS£AW WARSZAWSKI  WOJSKA CZESKIEGO 43 BRNO 02647068610206295479391221,16,-16930.00
2016-06-06,PRZELEW UZNANIOWY (NADANO 06-06-2016) SK£ADKA CZ£ONKOWSKA ZA MIESI¥C 06-2016  DAWID RYBSKI  WOJSKA CZESKIEGO 43 BRNO 94305553417675099599733873,64,-16994.00
2016-06-07,PRZELEW UZNANIOWY (NADANO 07-06-2016) SK£ADKA CZ£ONKOWSKA ZA MIESI¥C 06-2016  STANIS£AW WARSZAWSKI  WOJSKA CZESKIEGO 43 BRNO 19859322516716228352701401,32,-17026.00
2016-06-08,PRZELEW UZNANIOWY (NADANO 08-06-2016) SK£ADKA CZ£ONKOWSKA ZA MIESI¥C 06-2016  OKTAWIAN NOWAK  WOJSKA CZESKIEGO 43 BRNO 12075584877524316345308673,32,-17058.00
2016-06-09,PRZELEW UZNANIOWY (NADANO 09-06-2016) SK£ADKA CZ£ONKOWSKA ZA MIESI¥C 06-2016  £UKASZ NOWAK  WOJSKA CZESKIEGO 43 BRNO 10778230965510351683044518,128,-17186.00
2016-06-10,PRZELEW UZNANIOWY (NADANO 10-06-2016) SK£ADKA CZ£ONKOWSKA ZA MIESI¥C 06-2016  MAREK STAROWSKI  WOJSKA CZESKIEGO 43 BRNO 43965749006607058838784695,128,-17314.00
2016-06-10,PRZELEW UZNANIOWY (NADANO 10-06-2016) SK£ADKA CZ£ONKOWSKA ZA MIESI¥C 06-2016  MAREK STAROWSKI  WOJSKA CZESKIEGO 43 BRNO 01706954092032265670769307,16,-17330.00
2016-06-12,PRZELEW UZNANIOWY (NADANO 12-06-2016) SK£ADKA CZ£ONKOWSKA ZA MIESI¥C 06-2016  STANIS£AW STAROWSKI  WOJSKA CZESKIEGO 43 BRNO 62149192062509208050065343,32,-17362.00
2016-06-12,PRZELEW UZNANIOWY (NADANO 12-06-2016) SK£ADKA CZ£ONKOWSKA ZA MIESI¥C 06-2016  BARTUŒ CZARNOWSKI  WOJSKA CZESKIEGO 43 BRNO 32306134773564008884600756,16,-17378.00
2016-06-14,PRZELEW OBCI¥¯ENIOWY (NADANO 14-06-2016) COS DO PLACENIA  TAURON  WOJSKA CZESKIEGO 43 BRNO 64578346089954736007213901,-693,-16685.00
2016-06-14,PRZELEW UZNANIOWY (NADANO 14-06-2016) DAROWIZNA  OKTAWIAN NOWAK  WOJSKA CZESKIEGO 43 BRNO 19962825416073336969042295,976,-17661.00
2016-06-16,PRZELEW UZNANIOWY (NADANO 16-06-2016) SK£ADKA CZ£ONKOWSKA ZA MIESI¥C 06-2016  DAREK NOWAK  WOJSKA CZESKIEGO 43 BRNO 82767616762626356326372736,32,-17693.00
2016-06-17,PRZELEW UZNANIOWY (NADANO 17-06-2016) DAROWIZNA  PAWE£ NOWAK  WOJSKA CZESKIEGO 43 BRNO 70823581010455258859180519,379,-18072.00
2016-06-18,PRZELEW UZNANIOWY (NADANO 18-06-2016) SK£ADKA CZ£ONKOWSKA ZA MIESI¥C 06-2016  DAREK NOWAK  WOJSKA CZESKIEGO 43 BRNO 26648037196129961349257516,32,-18104.00
2016-06-19,PRZELEW OBCI¥¯ENIOWY (NADANO 19-06-2016) COS DO PLACENIA  TAURON  WOJSKA CZESKIEGO 43 BRNO 18753630602743150915164973,-790,-17314.00
2016-06-19,PRZELEW UZNANIOWY (NADANO 19-06-2016) SK£ADKA CZ£ONKOWSKA ZA MIESI¥C 06-2016  MICHA£ KOWALSKI  WOJSKA CZESKIEGO 43 BRNO 24810145999102071038595600,32,-17346.00
2016-06-20,PRZELEW OBCI¥¯ENIOWY (NADANO 20-06-2016) COS DO PLACENIA  TAURON  WOJSKA CZESKIEGO 43 BRNO 91469616628973938950302452,-929,-16417.00
2016-06-22,PRZELEW OBCI¥¯ENIOWY (NADANO 22-06-2016) COS DO PLACENIA  TAURON  WOJSKA CZESKIEGO 43 BRNO 85380729019188423533114993,-880,-15537.00
2016-06-23,PRZELEW UZNANIOWY (NADANO 23-06-2016) SK£ADKA CZ£ONKOWSKA ZA MIESI¥C 06-2016  £UKASZ STAROWSKI  WOJSKA CZESKIEGO 43 BRNO 27452344023531966129732641,16,-15553.00
2016-06-24,PRZELEW OBCI¥¯ENIOWY (NADANO 24-06-2016) COS DO PLACENIA  UPC  WOJSKA CZESKIEGO 43 BRNO 22681550692093658342764975,-804,-14749.00
2016-06-26,PRZELEW UZNANIOWY (NADANO 26-06-2016) SK£ADKA CZ£ONKOWSKA ZA MIESI¥C 06-2016  PAWE£ KOWALSKI  WOJSKA CZESKIEGO 43 BRNO 72596817299315222010963974,32,-14781.00
2016-06-27,PRZELEW UZNANIOWY (NADANO 27-06-2016) SK£ADKA CZ£ONKOWSKA ZA MIESI¥C 06-2016  DAWID RYBSKI  WOJSKA CZESKIEGO 43 BRNO 44513342592525603379866223,128,-14909.00
2016-06-27,PRZELEW UZNANIOWY (NADANO 27-06-2016) SK£ADKA CZ£ONKOWSKA ZA MIESI¥C 06-2016  OKTAWIAN NOWAK  WOJSKA CZESKIEGO 43 BRNO 84849016530686629417655101,128,-15037.00
2016-06-28,PRZELEW UZNANIOWY (NADANO 28-06-2016) SK£ADKA CZ£ONKOWSKA ZA MIESI¥C 06-2016  BARTUŒ TESTOWSKI  WOJSKA CZESKIEGO 43 BRNO 78548142925886670542982260,128,-15165.00
2016-06-29,PRZELEW UZNANIOWY (NADANO 29-06-2016) SK£ADKA CZ£ONKOWSKA ZA MIESI¥C 06-2016  MAREK TESTOWSKI  WOJSKA CZESKIEGO 43 BRNO 66991699313766860326411985,16,-15181.00
2016-07-01,PRZELEW UZNANIOWY (NADANO 01-07-2016) DAROWIZNA  BARTUŒ TESTOWSKI  WOJSKA CZESKIEGO 43 BRNO 91767647269606077178748253,993,-16174.00
2016-07-01,PRZELEW OBCI¥¯ENIOWY (NADANO 01-07-2016) COS DO PLACENIA  TAURON  WOJSKA CZESKIEGO 43 BRNO 10319021846186888081765401,-360,-15814.00
2016-07-01,PRZELEW OBCI¥¯ENIOWY (NADANO 01-07-2016) COS DO PLACENIA  LOKAL  WOJSKA CZESKIEGO 43 BRNO 44307510061986849880752838,-716,-15098.00
2016-07-03,PRZELEW UZNANIOWY (NADANO 03-07-2016) SK£ADKA CZ£ONKOWSKA ZA MIESI¥C 07-2016  STANIS£AW OWCZAREK  WOJSKA CZESKIEGO 43 BRNO 73793013245887946424482508,32,-15130.00
2016-07-03,PRZELEW UZNANIOWY (NADANO 03-07-2016) SK£ADKA CZ£ONKOWSKA ZA MIESI¥C 07-2016  HENRYK CHOLERAWIECKI  WOJSKA CZESKIEGO 43 BRNO 41013332222621290245989111,32,-15162.00
2016-07-05,PRZELEW UZNANIOWY (NADANO 05-07-2016) SK£ADKA CZ£ONKOWSKA ZA MIESI¥C 07-2016  STANIS£AW STAROWSKI  WOJSKA CZESKIEGO 43 BRNO 57246813364191721535732965,32,-15194.00
2016-07-05,PRZELEW UZNANIOWY (NADANO 05-07-2016) SK£ADKA CZ£ONKOWSKA ZA MIESI¥C 07-2016  DAWID RYBSKI  WOJSKA CZESKIEGO 43 BRNO 66397308522128650787943446,128,-15322.00
2016-07-05,PRZELEW UZNANIOWY (NADANO 05-07-2016) DAROWIZNA  £UKASZ STAROWSKI  WOJSKA CZESKIEGO 43 BRNO 23058594973385147228235954,552,-15874.00
2016-07-06,PRZELEW OBCI¥¯ENIOWY (NADANO 06-07-2016) COS DO PLACENIA  TAURON  WOJSKA CZESKIEGO 43 BRNO 37168649185092339232412097,-429,-15445.00
2016-07-07,PRZELEW UZNANIOWY (NADANO 07-07-2016) SK£ADKA CZ£ONKOWSKA ZA MIESI¥C 07-2016  £UKASZ NOWAK  WOJSKA CZESKIEGO 43 BRNO 92479870680107147580900879,32,-15477.00
2016-07-09,PRZELEW UZNANIOWY (NADANO 09-07-2016) SK£ADKA CZ£ONKOWSKA ZA MIESI¥C 07-2016  MAREK NOWAK  WOJSKA CZESKIEGO 43 BRNO 47689554169043926386598380,16,-15493.00
2016-07-09,PRZELEW UZNANIOWY (NADANO 09-07-2016) SK£ADKA CZ£ONKOWSKA ZA MIESI¥C 07-2016  PAWE£ NOWAK  WOJSKA CZESKIEGO 43 BRNO 58602323399266173540202181,128,-15621.00
2016-07-09,PRZELEW UZNANIOWY (NADANO 09-07-2016) SK£ADKA CZ£ONKOWSKA ZA MIESI¥C 07-2016  OKTAWIAN RYBSKI  WOJSKA CZESKIEGO 43 BRNO 72740495890588303185531386,128,-15749.00
2016-07-10,PRZELEW UZNANIOWY (NADANO 10-07-2016) SK£ADKA CZ£ONKOWSKA ZA MIESI¥C 07-2016  MAREK NOWAK  WOJSKA CZESKIEGO 43 BRNO 85990269365010440966692079,128,-15877.00
2016-07-10,PRZELEW UZNANIOWY (NADANO 10-07-2016) SK£ADKA CZ£ONKOWSKA ZA MIESI¥C 07-2016  PAWE£ NOWAK  WOJSKA CZESKIEGO 43 BRNO 27831517997950594380133661,128,-16005.00
2016-07-11,PRZELEW UZNANIOWY (NADANO 11-07-2016) SK£ADKA CZ£ONKOWSKA ZA MIESI¥C 07-2016  MAREK OWCZAREK  WOJSKA CZESKIEGO 43 BRNO 96730225019623080675480688,128,-16133.00
2016-07-12,PRZELEW UZNANIOWY (NADANO 12-07-2016) SK£ADKA CZ£ONKOWSKA ZA MIESI¥C 07-2016  STANIS£AW STAROWSKI  WOJSKA CZESKIEGO 43 BRNO 81719171523588684679608540,128,-16261.00
2016-07-12,PRZELEW UZNANIOWY (NADANO 12-07-2016) SK£ADKA CZ£ONKOWSKA ZA MIESI¥C 07-2016  STANIS£AW STAROWSKI  WOJSKA CZESKIEGO 43 BRNO 31244399003983264791118958,16,-16277.00
2016-07-14,PRZELEW UZNANIOWY (NADANO 14-07-2016) SK£ADKA CZ£ONKOWSKA ZA MIESI¥C 07-2016  HENRYK KOWALSKI  WOJSKA CZESKIEGO 43 BRNO 47343327766927892474663882,64,-16341.00
2016-07-16,PRZELEW UZNANIOWY (NADANO 16-07-2016) SK£ADKA CZ£ONKOWSKA ZA MIESI¥C 07-2016  OKTAWIAN NOWAK  WOJSKA CZESKIEGO 43 BRNO 45202115037753799272707335,32,-16373.00
2016-07-16,PRZELEW UZNANIOWY (NADANO 16-07-2016) SK£ADKA CZ£ONKOWSKA ZA MIESI¥C 07-2016  £UKASZ NOWAK  WOJSKA CZESKIEGO 43 BRNO 62827999123455270563934662,32,-16405.00
2016-07-16,PRZELEW UZNANIOWY (NADANO 16-07-2016) SK£ADKA CZ£ONKOWSKA ZA MIESI¥C 07-2016  BARTUŒ TESTOWSKI  WOJSKA CZESKIEGO 43 BRNO 22736407530623716838351970,128,-16533.00
2016-07-17,PRZELEW UZNANIOWY (NADANO 17-07-2016) SK£ADKA CZ£ONKOWSKA ZA MIESI¥C 07-2016  BARTUŒ CZARNOWSKI  WOJSKA CZESKIEGO 43 BRNO 85409331539976513456733494,64,-16597.00
2016-07-19,PRZELEW UZNANIOWY (NADANO 19-07-2016) SK£ADKA CZ£ONKOWSKA ZA MIESI¥C 07-2016  STANIS£AW WARSZAWSKI  WOJSKA CZESKIEGO 43 BRNO 41693269155680000165341439,16,-16613.00
2016-07-20,PRZELEW OBCI¥¯ENIOWY (NADANO 20-07-2016) COS DO PLACENIA  UPC  WOJSKA CZESKIEGO 43 BRNO 67569323296702154007699505,-606,-16007.00
2016-07-21,PRZELEW UZNANIOWY (NADANO 21-07-2016) SK£ADKA CZ£ONKOWSKA ZA MIESI¥C 07-2016  £UKASZ WARSZAWSKI  WOJSKA CZESKIEGO 43 BRNO 83090971293698727448800987,64,-16071.00
2016-07-23,PRZELEW UZNANIOWY (NADANO 23-07-2016) SK£ADKA CZ£ONKOWSKA ZA MIESI¥C 07-2016  MICHA£ KOWALSKI  WOJSKA CZESKIEGO 43 BRNO 19035459587639212272487800,64,-16135.00
2016-07-23,PRZELEW UZNANIOWY (NADANO 23-07-2016) SK£ADKA CZ£ONKOWSKA ZA MIESI¥C 07-2016  £UKASZ WARSZAWSKI  WOJSKA CZESKIEGO 43 BRNO 17108342213722758779005047,32,-16167.00
2016-07-25,PRZELEW UZNANIOWY (NADANO 25-07-2016) SK£ADKA CZ£ONKOWSKA ZA MIESI¥C 07-2016  £UKASZ WARSZAWSKI  WOJSKA CZESKIEGO 43 BRNO 96967993810358060240879881,16,-16183.00
2016-07-27,PRZELEW UZNANIOWY (NADANO 27-07-2016) SK£ADKA CZ£ONKOWSKA ZA MIESI¥C 07-2016  £UKASZ NOWAK  WOJSKA CZESKIEGO 43 BRNO 65628056910016480950296433,64,-16247.00
2016-07-27,PRZELEW UZNANIOWY (NADANO 27-07-2016) SK£ADKA CZ£ONKOWSKA ZA MIESI¥C 07-2016  MAREK STAROWSKI  WOJSKA CZESKIEGO 43 BRNO 97091066728340058706525985,64,-16311.00
2016-07-28,PRZELEW UZNANIOWY (NADANO 28-07-2016) DAROWIZNA  MAREK CZARNOWSKI  WOJSKA CZESKIEGO 43 BRNO 95313835638584634340843631,406,-16717.00
2016-07-29,PRZELEW UZNANIOWY (NADANO 29-07-2016) SK£ADKA CZ£ONKOWSKA ZA MIESI¥C 07-2016  PAWE£ KOWALSKI  WOJSKA CZESKIEGO 43 BRNO 33739312982987475732808271,64,-16781.00
2016-07-31,PRZELEW UZNANIOWY (NADANO 31-07-2016) DAROWIZNA  MAREK CZARNOWSKI  WOJSKA CZESKIEGO 43 BRNO 98007729451262905343571396,869,-17650.00
2016-08-01,PRZELEW UZNANIOWY (NADANO 01-08-2016) DAROWIZNA  MAREK NOWAK  WOJSKA CZESKIEGO 43 BRNO 57163349341351653266692831,649,-18299.00
2016-08-01,PRZELEW UZNANIOWY (NADANO 01-08-2016) SK£ADKA CZ£ONKOWSKA ZA MIESI¥C 08-2016  £UKASZ WARSZAWSKI  WOJSKA CZESKIEGO 43 BRNO 54157954921637497030698565,128,-18427.00
2016-08-02,PRZELEW UZNANIOWY (NADANO 02-08-2016) SK£ADKA CZ£ONKOWSKA ZA MIESI¥C 08-2016  DAWID NOWAK  WOJSKA CZESKIEGO 43 BRNO 51358135822741967004127232,32,-18459.00
2016-08-03,PRZELEW UZNANIOWY (NADANO 03-08-2016) SK£ADKA CZ£ONKOWSKA ZA MIESI¥C 08-2016  DAWID NOWAK  WOJSKA CZESKIEGO 43 BRNO 54774888018889097064078705,32,-18491.00
2016-08-05,PRZELEW UZNANIOWY (NADANO 05-08-2016) DAROWIZNA  HENRYK CHOLERAWIECKI  WOJSKA CZESKIEGO 43 BRNO 57723543357970960563813650,1010,-19501.00
2016-08-06,PRZELEW UZNANIOWY (NADANO 06-08-2016) SK£ADKA CZ£ONKOWSKA ZA MIESI¥C 08-2016  MAREK NOWAK  WOJSKA CZESKIEGO 43 BRNO 30192101124854281356083893,64,-19565.00
2016-08-08,PRZELEW UZNANIOWY (NADANO 08-08-2016) SK£ADKA CZ£ONKOWSKA ZA MIESI¥C 08-2016  MICHA£ KOWALSKI  WOJSKA CZESKIEGO 43 BRNO 53186456536427360592350079,32,-19597.00
2016-08-09,PRZELEW UZNANIOWY (NADANO 09-08-2016) SK£ADKA CZ£ONKOWSKA ZA MIESI¥C 08-2016  PAWE£ NOWAK  WOJSKA CZESKIEGO 43 BRNO 04458129515774594341272627,128,-19725.00
2016-08-09,PRZELEW UZNANIOWY (NADANO 09-08-2016) SK£ADKA CZ£ONKOWSKA ZA MIESI¥C 08-2016  DAWID RYBSKI  WOJSKA CZESKIEGO 43 BRNO 95146899543499787084573187,16,-19741.00
2016-08-11,PRZELEW UZNANIOWY (NADANO 11-08-2016) DAROWIZNA  MICHA£ WARSZAWSKI  WOJSKA CZESKIEGO 43 BRNO 72933190988001674320123424,620,-20361.00
2016-08-12,PRZELEW UZNANIOWY (NADANO 12-08-2016) SK£ADKA CZ£ONKOWSKA ZA MIESI¥C 08-2016  OKTAWIAN NOWAK  WOJSKA CZESKIEGO 43 BRNO 44319686237053268889250160,128,-20489.00
2016-08-14,PRZELEW UZNANIOWY (NADANO 14-08-2016) SK£ADKA CZ£ONKOWSKA ZA MIESI¥C 08-2016  £UKASZ NOWAK  WOJSKA CZESKIEGO 43 BRNO 63989731298112366542717188,64,-20553.00
2016-08-16,PRZELEW OBCI¥¯ENIOWY (NADANO 16-08-2016) COS DO PLACENIA  TAURON  WOJSKA CZESKIEGO 43 BRNO 40657585958051891294114987,-317,-20236.00
2016-08-16,PRZELEW UZNANIOWY (NADANO 16-08-2016) SK£ADKA CZ£ONKOWSKA ZA MIESI¥C 08-2016  BARTUŒ CZARNOWSKI  WOJSKA CZESKIEGO 43 BRNO 65680333971803419151509550,128,-20364.00
2016-08-16,PRZELEW UZNANIOWY (NADANO 16-08-2016) SK£ADKA CZ£ONKOWSKA ZA MIESI¥C 08-2016  MICHA£ CZARNOWSKI  WOJSKA CZESKIEGO 43 BRNO 83176680861151695722389437,64,-20428.00
2016-08-18,PRZELEW UZNANIOWY (NADANO 18-08-2016) SK£ADKA CZ£ONKOWSKA ZA MIESI¥C 08-2016  MAREK STAROWSKI  WOJSKA CZESKIEGO 43 BRNO 94780861997018238491671006,64,-20492.00
2016-08-20,PRZELEW UZNANIOWY (NADANO 20-08-2016) SK£ADKA CZ£ONKOWSKA ZA MIESI¥C 08-2016  £UKASZ WARSZAWSKI  WOJSKA CZESKIEGO 43 BRNO 01302409808124819304016737,64,-20556.00
2016-08-21,PRZELEW UZNANIOWY (NADANO 21-08-2016) DAROWIZNA  HENRYK CHOLERAWIECKI  WOJSKA CZESKIEGO 43 BRNO 07359395482317768045719021,576,-21132.00
2016-08-22,PRZELEW UZNANIOWY (NADANO 22-08-2016) DAROWIZNA  DAWID MARKOWSKI  WOJSKA CZESKIEGO 43 BRNO 91760044375802630496861524,778,-21910.00
2016-08-22,PRZELEW UZNANIOWY (NADANO 22-08-2016) SK£ADKA CZ£ONKOWSKA ZA MIESI¥C 08-2016  MAREK OWCZAREK  WOJSKA CZESKIEGO 43 BRNO 22691966677705922677838426,16,-21926.00
2016-08-24,PRZELEW UZNANIOWY (NADANO 24-08-2016) SK£ADKA CZ£ONKOWSKA ZA MIESI¥C 08-2016  OKTAWIAN NOWAK  WOJSKA CZESKIEGO 43 BRNO 21772373016447587066035005,128,-22054.00
2016-08-26,PRZELEW UZNANIOWY (NADANO 26-08-2016) SK£ADKA CZ£ONKOWSKA ZA MIESI¥C 08-2016  DAWID NOWAK  WOJSKA CZESKIEGO 43 BRNO 01984635543491540047767468,32,-22086.00
2016-08-28,PRZELEW UZNANIOWY (NADANO 28-08-2016) SK£ADKA CZ£ONKOWSKA ZA MIESI¥C 08-2016  DAREK NOWAK  WOJSKA CZESKIEGO 43 BRNO 17388172305027084063697383,128,-22214.00
2016-08-28,PRZELEW UZNANIOWY (NADANO 28-08-2016) DAROWIZNA  OKTAWIAN PROSTACKI  WOJSKA CZESKIEGO 43 BRNO 60172986272149820738198491,259,-22473.00
2016-08-29,PRZELEW OBCI¥¯ENIOWY (NADANO 29-08-2016) COS DO PLACENIA  LOKAL  WOJSKA CZESKIEGO 43 BRNO 52545786340522084542078847,-560,-21913.00
2016-08-31,PRZELEW UZNANIOWY (NADANO 31-08-2016) SK£ADKA CZ£ONKOWSKA ZA MIESI¥C 08-2016  STANIS£AW STAROWSKI  WOJSKA CZESKIEGO 43 BRNO 11085906514369629198155467,64,-21977.00
2016-08-31,PRZELEW UZNANIOWY (NADANO 31-08-2016) SK£ADKA CZ£ONKOWSKA ZA MIESI¥C 08-2016  MAREK NOWAK  WOJSKA CZESKIEGO 43 BRNO 81011136803116868487692007,128,-22105.00
2016-08-31,PRZELEW UZNANIOWY (NADANO 31-08-2016) DAROWIZNA  BARTUŒ CZARNOWSKI  WOJSKA CZESKIEGO 43 BRNO 60681074833135542177283503,924,-23029.00
2016-09-01,PRZELEW UZNANIOWY (NADANO 01-09-2016) DAROWIZNA  MICHA£ WARSZAWSKI  WOJSKA CZESKIEGO 43 BRNO 99656664493474137606241941,490,-23519.00
2016-09-01,PRZELEW OBCI¥¯ENIOWY (NADANO 01-09-2016) COS DO PLACENIA  TAURON  WOJSKA CZESKIEGO 43 BRNO 73202115188055728167864117,-730,-22789.00
2016-09-03,PRZELEW UZNANIOWY (NADANO 03-09-2016) SK£ADKA CZ£ONKOWSKA ZA MIESI¥C 09-2016  £UKASZ NOWAK  WOJSKA CZESKIEGO 43 BRNO 26898119688500232154450689,32,-22821.00
2016-09-04,PRZELEW UZNANIOWY (NADANO 04-09-2016) SK£ADKA CZ£ONKOWSKA ZA MIESI¥C 09-2016  PAWE£ NOWAK  WOJSKA CZESKIEGO 43 BRNO 21634439948874370032065586,32,-22853.00
2016-09-05,PRZELEW UZNANIOWY (NADANO 05-09-2016) SK£ADKA CZ£ONKOWSKA ZA MIESI¥C 09-2016  STANIS£AW CZARNOWSKI  WOJSKA CZESKIEGO 43 BRNO 76992562361764702950749343,32,-22885.00
2016-09-07,PRZELEW UZNANIOWY (NADANO 07-09-2016) SK£ADKA CZ£ONKOWSKA ZA MIESI¥C 09-2016  STANIS£AW STAROWSKI  WOJSKA CZESKIEGO 43 BRNO 28084602734784582121964111,128,-23013.00
2016-09-09,PRZELEW UZNANIOWY (NADANO 09-09-2016) SK£ADKA CZ£ONKOWSKA ZA MIESI¥C 09-2016  MICHA£ WARSZAWSKI  WOJSKA CZESKIEGO 43 BRNO 60999514342180371307377162,16,-23029.00
2016-09-10,PRZELEW UZNANIOWY (NADANO 10-09-2016) SK£ADKA CZ£ONKOWSKA ZA MIESI¥C 09-2016  PAWE£ NOWAK  WOJSKA CZESKIEGO 43 BRNO 21541331613715986728110759,16,-23045.00
2016-09-12,PRZELEW UZNANIOWY (NADANO 12-09-2016) SK£ADKA CZ£ONKOWSKA ZA MIESI¥C 09-2016  STANIS£AW MARKOWSKI  WOJSKA CZESKIEGO 43 BRNO 56761083387824954395517455,32,-23077.00
2016-09-14,PRZELEW UZNANIOWY (NADANO 14-09-2016) SK£ADKA CZ£ONKOWSKA ZA MIESI¥C 09-2016  MAREK CZARNOWSKI  WOJSKA CZESKIEGO 43 BRNO 04995502385974589761160584,16,-23093.00
2016-09-16,PRZELEW OBCI¥¯ENIOWY (NADANO 16-09-2016) COS DO PLACENIA  TAURON  WOJSKA CZESKIEGO 43 BRNO 31457529535485025181606950,-284,-22809.00
2016-09-18,PRZELEW UZNANIOWY (NADANO 18-09-2016) SK£ADKA CZ£ONKOWSKA ZA MIESI¥C 09-2016  STANIS£AW CZARNOWSKI  WOJSKA CZESKIEGO 43 BRNO 37770140029739650193189689,32,-22841.00
2016-09-19,PRZELEW UZNANIOWY (NADANO 19-09-2016) SK£ADKA CZ£ONKOWSKA ZA MIESI¥C 09-2016  HENRYK CHOLERAWIECKI  WOJSKA CZESKIEGO 43 BRNO 00520298892065409712106241,128,-22969.00
2016-09-21,PRZELEW UZNANIOWY (NADANO 21-09-2016) SK£ADKA CZ£ONKOWSKA ZA MIESI¥C 09-2016  £UKASZ NOWAK  WOJSKA CZESKIEGO 43 BRNO 01580206029958913668630988,128,-23097.00
2016-09-23,PRZELEW UZNANIOWY (NADANO 23-09-2016) SK£ADKA CZ£ONKOWSKA ZA MIESI¥C 09-2016  OKTAWIAN RYBSKI  WOJSKA CZESKIEGO 43 BRNO 53108140792875603554126595,128,-23225.00
2016-09-25,PRZELEW UZNANIOWY (NADANO 25-09-2016) SK£ADKA CZ£ONKOWSKA ZA MIESI¥C 09-2016  STANIS£AW WARSZAWSKI  WOJSKA CZESKIEGO 43 BRNO 83980276848942205958876072,16,-23241.00
2016-09-27,PRZELEW UZNANIOWY (NADANO 27-09-2016) SK£ADKA CZ£ONKOWSKA ZA MIESI¥C 09-2016  DAWID RYBSKI  WOJSKA CZESKIEGO 43 BRNO 74569524515000585812062867,128,-23369.00
2016-09-28,PRZELEW UZNANIOWY (NADANO 28-09-2016) SK£ADKA CZ£ONKOWSKA ZA MIESI¥C 09-2016  MAREK NOWAK  WOJSKA CZESKIEGO 43 BRNO 80736550142037913891790397,128,-23497.00
2016-09-28,PRZELEW UZNANIOWY (NADANO 28-09-2016) SK£ADKA CZ£ONKOWSKA ZA MIESI¥C 09-2016  STANIS£AW MARKOWSKI  WOJSKA CZESKIEGO 43 BRNO 08657720615475691062571060,16,-23513.00
2016-09-29,PRZELEW UZNANIOWY (NADANO 29-09-2016) SK£ADKA CZ£ONKOWSKA ZA MIESI¥C 09-2016  BARTUŒ NOWAK  WOJSKA CZESKIEGO 43 BRNO 36582417560108277033777054,128,-23641.00
2016-09-30,PRZELEW UZNANIOWY (NADANO 30-09-2016) SK£ADKA CZ£ONKOWSKA ZA MIESI¥C 09-2016  MAREK STAROWSKI  WOJSKA CZESKIEGO 43 BRNO 93259488772409077857319755,16,-23657.00
2016-10-01,PRZELEW UZNANIOWY (NADANO 01-10-2016) SK£ADKA CZ£ONKOWSKA ZA MIESI¥C 10-2016  MAREK CZARNOWSKI  WOJSKA CZESKIEGO 43 BRNO 08007645933575776756933616,64,-23721.00
2016-10-03,PRZELEW OBCI¥¯ENIOWY (NADANO 03-10-2016) COS DO PLACENIA  LOKAL  WOJSKA CZESKIEGO 43 BRNO 83785081572008310733810734,-263,-23458.00
2016-10-05,PRZELEW UZNANIOWY (NADANO 05-10-2016) SK£ADKA CZ£ONKOWSKA ZA MIESI¥C 10-2016  DAWID RYBSKI  WOJSKA CZESKIEGO 43 BRNO 19889798513276491785232422,64,-23522.00
2016-10-05,PRZELEW UZNANIOWY (NADANO 05-10-2016) SK£ADKA CZ£ONKOWSKA ZA MIESI¥C 10-2016  OKTAWIAN NOWAK  WOJSKA CZESKIEGO 43 BRNO 42809887371341075984643097,32,-23554.00
2016-10-05,PRZELEW UZNANIOWY (NADANO 05-10-2016) SK£ADKA CZ£ONKOWSKA ZA MIESI¥C 10-2016  STANIS£AW WARSZAWSKI  WOJSKA CZESKIEGO 43 BRNO 78517811365196961198131714,32,-23586.00
2016-10-07,PRZELEW UZNANIOWY (NADANO 07-10-2016) SK£ADKA CZ£ONKOWSKA ZA MIESI¥C 10-2016  MAREK OWCZAREK  WOJSKA CZESKIEGO 43 BRNO 89746404326050272268624916,128,-23714.00
2016-10-09,PRZELEW UZNANIOWY (NADANO 09-10-2016) SK£ADKA CZ£ONKOWSKA ZA MIESI¥C 10-2016  MAREK NOWAK  WOJSKA CZESKIEGO 43 BRNO 02015637327076097480439028,16,-23730.00
2016-10-11,PRZELEW UZNANIOWY (NADANO 11-10-2016) SK£ADKA CZ£ONKOWSKA ZA MIESI¥C 10-2016  HENRYK CHOLERAWIECKI  WOJSKA CZESKIEGO 43 BRNO 62775919169015479838745615,64,-23794.00
2016-10-12,PRZELEW UZNANIOWY (NADANO 12-10-2016) SK£ADKA CZ£ONKOWSKA ZA MIESI¥C 10-2016  PAWE£ KOWALSKI  WOJSKA CZESKIEGO 43 BRNO 34216594612639738965984260,64,-23858.00
2016-10-14,PRZELEW UZNANIOWY (NADANO 14-10-2016) SK£ADKA CZ£ONKOWSKA ZA MIESI¥C 10-2016  STANIS£AW MARKOWSKI  WOJSKA CZESKIEGO 43 BRNO 39916852328105953739400600,64,-23922.00
2016-10-16,PRZELEW UZNANIOWY (NADANO 16-10-2016) SK£ADKA CZ£ONKOWSKA ZA MIESI¥C 10-2016  OKTAWIAN RYBSKI  WOJSKA CZESKIEGO 43 BRNO 86490471694343223185143306,64,-23986.00
2016-10-16,PRZELEW UZNANIOWY (NADANO 16-10-2016) SK£ADKA CZ£ONKOWSKA ZA MIESI¥C 10-2016  STANIS£AW CZARNOWSKI  WOJSKA CZESKIEGO 43 BRNO 85372716030234083099516007,16,-24002.00
2016-10-16,PRZELEW UZNANIOWY (NADANO 16-10-2016) SK£ADKA CZ£ONKOWSKA ZA MIESI¥C 10-2016  OKTAWIAN RYBSKI  WOJSKA CZESKIEGO 43 BRNO 19720905617384742570459057,64,-24066.00
2016-10-17,PRZELEW UZNANIOWY (NADANO 17-10-2016) SK£ADKA CZ£ONKOWSKA ZA MIESI¥C 10-2016  MAREK TESTOWSKI  WOJSKA CZESKIEGO 43 BRNO 47480529129657473852634005,32,-24098.00
2016-10-18,PRZELEW UZNANIOWY (NADANO 18-10-2016) SK£ADKA CZ£ONKOWSKA ZA MIESI¥C 10-2016  MAREK OWCZAREK  WOJSKA CZESKIEGO 43 BRNO 71319212912605596481313200,64,-24162.00
2016-10-19,PRZELEW UZNANIOWY (NADANO 19-10-2016) SK£ADKA CZ£ONKOWSKA ZA MIESI¥C 10-2016  STANIS£AW OWCZAREK  WOJSKA CZESKIEGO 43 BRNO 56152791084124914869081471,32,-24194.00
2016-10-19,PRZELEW OBCI¥¯ENIOWY (NADANO 19-10-2016) COS DO PLACENIA  UPC  WOJSKA CZESKIEGO 43 BRNO 14030866087618771429520851,-1008,-23186.00
2016-10-19,PRZELEW UZNANIOWY (NADANO 19-10-2016) SK£ADKA CZ£ONKOWSKA ZA MIESI¥C 10-2016  MAREK TESTOWSKI  WOJSKA CZESKIEGO 43 BRNO 47447820424636169809791330,16,-23202.00
2016-10-21,PRZELEW UZNANIOWY (NADANO 21-10-2016) SK£ADKA CZ£ONKOWSKA ZA MIESI¥C 10-2016  BARTUŒ TESTOWSKI  WOJSKA CZESKIEGO 43 BRNO 51371327023754367076798389,32,-23234.00
2016-10-23,PRZELEW UZNANIOWY (NADANO 23-10-2016) DAROWIZNA  STANIS£AW WARSZAWSKI  WOJSKA CZESKIEGO 43 BRNO 94623327470290845602703634,349,-23583.00
2016-10-23,PRZELEW UZNANIOWY (NADANO 23-10-2016) SK£ADKA CZ£ONKOWSKA ZA MIESI¥C 10-2016  HENRYK CHOLERAWIECKI  WOJSKA CZESKIEGO 43 BRNO 79647082776435602179409403,64,-23647.00
2016-10-25,PRZELEW UZNANIOWY (NADANO 25-10-2016) DAROWIZNA  MAREK NOWAK  WOJSKA CZESKIEGO 43 BRNO 96846177122028779673084180,825,-24472.00
2016-10-25,PRZELEW UZNANIOWY (NADANO 25-10-2016) DAROWIZNA  BARTUŒ TESTOWSKI  WOJSKA CZESKIEGO 43 BRNO 29024445493726840039089663,604,-25076.00
2016-10-26,PRZELEW UZNANIOWY (NADANO 26-10-2016) SK£ADKA CZ£ONKOWSKA ZA MIESI¥C 10-2016  DAWID NOWAK  WOJSKA CZESKIEGO 43 BRNO 64421363571677594953708096,128,-25204.00
2016-10-27,PRZELEW UZNANIOWY (NADANO 27-10-2016) SK£ADKA CZ£ONKOWSKA ZA MIESI¥C 10-2016  STANIS£AW CZARNOWSKI  WOJSKA CZESKIEGO 43 BRNO 35028127632521183377850154,32,-25236.00
2016-10-27,PRZELEW UZNANIOWY (NADANO 27-10-2016) SK£ADKA CZ£ONKOWSKA ZA MIESI¥C 10-2016  PAWE£ KOWALSKI  WOJSKA CZESKIEGO 43 BRNO 13754475074712548548191037,128,-25364.00
2016-10-29,PRZELEW UZNANIOWY (NADANO 29-10-2016) SK£ADKA CZ£ONKOWSKA ZA MIESI¥C 10-2016  MICHA£ CZARNOWSKI  WOJSKA CZESKIEGO 43 BRNO 77810304974981991230157437,32,-25396.00
2016-10-31,PRZELEW UZNANIOWY (NADANO 31-10-2016) SK£ADKA CZ£ONKOWSKA ZA MIESI¥C 10-2016  OKTAWIAN RYBSKI  WOJSKA CZESKIEGO 43 BRNO 04706114825548394847591284,64,-25460.00
2016-11-01,PRZELEW UZNANIOWY (NADANO 01-11-2016) SK£ADKA CZ£ONKOWSKA ZA MIESI¥C 11-2016  STANIS£AW MARKOWSKI  WOJSKA CZESKIEGO 43 BRNO 25974157465403615719450098,32,-25492.00
2016-11-03,PRZELEW UZNANIOWY (NADANO 03-11-2016) SK£ADKA CZ£ONKOWSKA ZA MIESI¥C 11-2016  HENRYK KOWALSKI  WOJSKA CZESKIEGO 43 BRNO 65691213941348297770029713,32,-25524.00
2016-11-04,PRZELEW UZNANIOWY (NADANO 04-11-2016) SK£ADKA CZ£ONKOWSKA ZA MIESI¥C 11-2016  HENRYK KOWALSKI  WOJSKA CZESKIEGO 43 BRNO 87519130748433180765434921,32,-25556.00
2016-11-05,PRZELEW UZNANIOWY (NADANO 05-11-2016) SK£ADKA CZ£ONKOWSKA ZA MIESI¥C 11-2016  £UKASZ STAROWSKI  WOJSKA CZESKIEGO 43 BRNO 88763751299633680781885484,64,-25620.00
2016-11-05,PRZELEW UZNANIOWY (NADANO 05-11-2016) SK£ADKA CZ£ONKOWSKA ZA MIESI¥C 11-2016  MAREK TESTOWSKI  WOJSKA CZESKIEGO 43 BRNO 41821313562291335949558116,64,-25684.00
2016-11-05,PRZELEW UZNANIOWY (NADANO 05-11-2016) SK£ADKA CZ£ONKOWSKA ZA MIESI¥C 11-2016  HENRYK CHOLERAWIECKI  WOJSKA CZESKIEGO 43 BRNO 37477431690021914397151681,32,-25716.00
2016-11-06,PRZELEW UZNANIOWY (NADANO 06-11-2016) SK£ADKA CZ£ONKOWSKA ZA MIESI¥C 11-2016  OKTAWIAN PROSTACKI  WOJSKA CZESKIEGO 43 BRNO 94206032028957076652312767,32,-25748.00
2016-11-07,PRZELEW UZNANIOWY (NADANO 07-11-2016) SK£ADKA CZ£ONKOWSKA ZA MIESI¥C 11-2016  £UKASZ NOWAK  WOJSKA CZESKIEGO 43 BRNO 40611849608034564193486268,64,-25812.00
2016-11-07,PRZELEW UZNANIOWY (NADANO 07-11-2016) SK£ADKA CZ£ONKOWSKA ZA MIESI¥C 11-2016  HENRYK CHOLERAWIECKI  WOJSKA CZESKIEGO 43 BRNO 15199678310028229455238711,128,-25940.00
2016-11-07,PRZELEW UZNANIOWY (NADANO 07-11-2016) SK£ADKA CZ£ONKOWSKA ZA MIESI¥C 11-2016  DAWID NOWAK  WOJSKA CZESKIEGO 43 BRNO 46973730912268643667532687,64,-26004.00
2016-11-08,PRZELEW OBCI¥¯ENIOWY (NADANO 08-11-2016) COS DO PLACENIA  UPC  WOJSKA CZESKIEGO 43 BRNO 69932054462764952860285229,-266,-25738.00
2016-11-08,PRZELEW UZNANIOWY (NADANO 08-11-2016) SK£ADKA CZ£ONKOWSKA ZA MIESI¥C 11-2016  DAWID NOWAK  WOJSKA CZESKIEGO 43 BRNO 41093009689714909151777435,128,-25866.00
2016-11-09,PRZELEW UZNANIOWY (NADANO 09-11-2016) SK£ADKA CZ£ONKOWSKA ZA MIESI¥C 11-2016  PAWE£ NOWAK  WOJSKA CZESKIEGO 43 BRNO 25647619632724521973058774,64,-25930.00
2016-11-09,PRZELEW OBCI¥¯ENIOWY (NADANO 09-11-2016) COS DO PLACENIA  UPC  WOJSKA CZESKIEGO 43 BRNO 91715037677038991597274971,-670,-25260.00
2016-11-09,PRZELEW UZNANIOWY (NADANO 09-11-2016) SK£ADKA CZ£ONKOWSKA ZA MIESI¥C 11-2016  OKTAWIAN PROSTACKI  WOJSKA CZESKIEGO 43 BRNO 12940425707002152739711860,128,-25388.00
2016-11-11,PRZELEW OBCI¥¯ENIOWY (NADANO 11-11-2016) COS DO PLACENIA  UPC  WOJSKA CZESKIEGO 43 BRNO 84218577174532902841759929,-805,-24583.00
2016-11-13,PRZELEW UZNANIOWY (NADANO 13-11-2016) SK£ADKA CZ£ONKOWSKA ZA MIESI¥C 11-2016  BARTUŒ TESTOWSKI  WOJSKA CZESKIEGO 43 BRNO 38064969713025816064507134,16,-24599.00
2016-11-13,PRZELEW UZNANIOWY (NADANO 13-11-2016) SK£ADKA CZ£ONKOWSKA ZA MIESI¥C 11-2016  MAREK NOWAK  WOJSKA CZESKIEGO 43 BRNO 07892999413788239204535610,32,-24631.00
2016-11-15,PRZELEW UZNANIOWY (NADANO 15-11-2016) DAROWIZNA  DAWID MARKOWSKI  WOJSKA CZESKIEGO 43 BRNO 43693606651134723527437321,830,-25461.00
2016-11-17,PRZELEW UZNANIOWY (NADANO 17-11-2016) SK£ADKA CZ£ONKOWSKA ZA MIESI¥C 11-2016  BARTUŒ TESTOWSKI  WOJSKA CZESKIEGO 43 BRNO 39862494211286018181972923,32,-25493.00
2016-11-19,PRZELEW UZNANIOWY (NADANO 19-11-2016) SK£ADKA CZ£ONKOWSKA ZA MIESI¥C 11-2016  MAREK OWCZAREK  WOJSKA CZESKIEGO 43 BRNO 64934923970490773638388356,32,-25525.00
2016-11-19,PRZELEW UZNANIOWY (NADANO 19-11-2016) DAROWIZNA  BARTUŒ TESTOWSKI  WOJSKA CZESKIEGO 43 BRNO 66574677287963058216784779,938,-26463.00
2016-11-20,PRZELEW UZNANIOWY (NADANO 20-11-2016) SK£ADKA CZ£ONKOWSKA ZA MIESI¥C 11-2016  MAREK CZARNOWSKI  WOJSKA CZESKIEGO 43 BRNO 07406566370853608213849548,64,-26527.00
2016-11-21,PRZELEW OBCI¥¯ENIOWY (NADANO 21-11-2016) COS DO PLACENIA  UPC  WOJSKA CZESKIEGO 43 BRNO 97121042220460297815073225,-930,-25597.00
2016-11-22,PRZELEW UZNANIOWY (NADANO 22-11-2016) DAROWIZNA  MICHA£ KOWALSKI  WOJSKA CZESKIEGO 43 BRNO 96658184286008145550610147,971,-26568.00
2016-11-23,PRZELEW UZNANIOWY (NADANO 23-11-2016) SK£ADKA CZ£ONKOWSKA ZA MIESI¥C 11-2016  MICHA£ KOWALSKI  WOJSKA CZESKIEGO 43 BRNO 15051455663119786584140124,16,-26584.00
2016-11-24,PRZELEW UZNANIOWY (NADANO 24-11-2016) SK£ADKA CZ£ONKOWSKA ZA MIESI¥C 11-2016  OKTAWIAN RYBSKI  WOJSKA CZESKIEGO 43 BRNO 89619793426748174124796855,16,-26600.00
2016-11-26,PRZELEW UZNANIOWY (NADANO 26-11-2016) SK£ADKA CZ£ONKOWSKA ZA MIESI¥C 11-2016  MAREK TESTOWSKI  WOJSKA CZESKIEGO 43 BRNO 83896493668492033647546996,128,-26728.00
2016-11-27,PRZELEW OBCI¥¯ENIOWY (NADANO 27-11-2016) COS DO PLACENIA  LOKAL  WOJSKA CZESKIEGO 43 BRNO 82043035366894449911880110,-445,-26283.00
2016-11-27,PRZELEW UZNANIOWY (NADANO 27-11-2016) SK£ADKA CZ£ONKOWSKA ZA MIESI¥C 11-2016  MAREK NOWAK  WOJSKA CZESKIEGO 43 BRNO 09776223402694147142500073,128,-26411.00
2016-11-28,PRZELEW UZNANIOWY (NADANO 28-11-2016) SK£ADKA CZ£ONKOWSKA ZA MIESI¥C 11-2016  MAREK STAROWSKI  WOJSKA CZESKIEGO 43 BRNO 29416469059470922692427497,16,-26427.00
2016-11-29,PRZELEW UZNANIOWY (NADANO 29-11-2016) SK£ADKA CZ£ONKOWSKA ZA MIESI¥C 11-2016  MAREK OWCZAREK  WOJSKA CZESKIEGO 43 BRNO 87182514734202283154656201,32,-26459.00
2016-12-01,PRZELEW UZNANIOWY (NADANO 01-12-2016) SK£ADKA CZ£ONKOWSKA ZA MIESI¥C 12-2016  £UKASZ WARSZAWSKI  WOJSKA CZESKIEGO 43 BRNO 48680193077803454736926252,64,-26523.00
2016-12-02,PRZELEW UZNANIOWY (NADANO 02-12-2016) SK£ADKA CZ£ONKOWSKA ZA MIESI¥C 12-2016  DAWID NOWAK  WOJSKA CZESKIEGO 43 BRNO 75749177210464394878740966,32,-26555.00
2016-12-03,PRZELEW UZNANIOWY (NADANO 03-12-2016) SK£ADKA CZ£ONKOWSKA ZA MIESI¥C 12-2016  BARTUŒ NOWAK  WOJSKA CZESKIEGO 43 BRNO 30992851172687794278267355,128,-26683.00
2016-12-03,PRZELEW UZNANIOWY (NADANO 03-12-2016) SK£ADKA CZ£ONKOWSKA ZA MIESI¥C 12-2016  MAREK CZARNOWSKI  WOJSKA CZESKIEGO 43 BRNO 02653114071496760246303707,128,-26811.00
2016-12-04,PRZELEW UZNANIOWY (NADANO 04-12-2016) SK£ADKA CZ£ONKOWSKA ZA MIESI¥C 12-2016  DAWID RYBSKI  WOJSKA CZESKIEGO 43 BRNO 83954159164545835012784833,128,-26939.00
2016-12-06,PRZELEW OBCI¥¯ENIOWY (NADANO 06-12-2016) COS DO PLACENIA  UPC  WOJSKA CZESKIEGO 43 BRNO 98353751654148289644545474,-387,-26552.00
2016-12-07,PRZELEW OBCI¥¯ENIOWY (NADANO 07-12-2016) COS DO PLACENIA  TAURON  WOJSKA CZESKIEGO 43 BRNO 42530839484166859071807840,-989,-25563.00
2016-12-07,PRZELEW UZNANIOWY (NADANO 07-12-2016) SK£ADKA CZ£ONKOWSKA ZA MIESI¥C 12-2016  BARTUŒ CZARNOWSKI  WOJSKA CZESKIEGO 43 BRNO 31130234593059618517174762,32,-25595.00
2016-12-09,PRZELEW UZNANIOWY (NADANO 09-12-2016) SK£ADKA CZ£ONKOWSKA ZA MIESI¥C 12-2016  DAWID RYBSKI  WOJSKA CZESKIEGO 43 BRNO 32029934879634070773184948,16,-25611.00
2016-12-11,PRZELEW UZNANIOWY (NADANO 11-12-2016) SK£ADKA CZ£ONKOWSKA ZA MIESI¥C 12-2016  HENRYK CHOLERAWIECKI  WOJSKA CZESKIEGO 43 BRNO 71684894955272546413188401,32,-25643.00
2016-12-12,PRZELEW UZNANIOWY (NADANO 12-12-2016) SK£ADKA CZ£ONKOWSKA ZA MIESI¥C 12-2016  OKTAWIAN RYBSKI  WOJSKA CZESKIEGO 43 BRNO 84857609690157830333130632,16,-25659.00
2016-12-13,PRZELEW UZNANIOWY (NADANO 13-12-2016) DAROWIZNA  MICHA£ KOWALSKI  WOJSKA CZESKIEGO 43 BRNO 51807089369215100675028130,673,-26332.00
2016-12-15,PRZELEW UZNANIOWY (NADANO 15-12-2016) SK£ADKA CZ£ONKOWSKA ZA MIESI¥C 12-2016  STANIS£AW OWCZAREK  WOJSKA CZESKIEGO 43 BRNO 34822204103502761145497091,32,-26364.00
2016-12-15,PRZELEW UZNANIOWY (NADANO 15-12-2016) SK£ADKA CZ£ONKOWSKA ZA MIESI¥C 12-2016  MAREK TESTOWSKI  WOJSKA CZESKIEGO 43 BRNO 12491428352442082426126524,128,-26492.00
2016-12-15,PRZELEW UZNANIOWY (NADANO 15-12-2016) SK£ADKA CZ£ONKOWSKA ZA MIESI¥C 12-2016  DAWID NOWAK  WOJSKA CZESKIEGO 43 BRNO 27468728053710039784388080,64,-26556.00
2016-12-17,PRZELEW UZNANIOWY (NADANO 17-12-2016) SK£ADKA CZ£ONKOWSKA ZA MIESI¥C 12-2016  MAREK NOWAK  WOJSKA CZESKIEGO 43 BRNO 22248891602314062187595756,32,-26588.00
2016-12-17,PRZELEW UZNANIOWY (NADANO 17-12-2016) SK£ADKA CZ£ONKOWSKA ZA MIESI¥C 12-2016  £UKASZ WARSZAWSKI  WOJSKA CZESKIEGO 43 BRNO 32082875542872241757778610,16,-26604.00
2016-12-19,PRZELEW UZNANIOWY (NADANO 19-12-2016) SK£ADKA CZ£ONKOWSKA ZA MIESI¥C 12-2016  STANIS£AW OWCZAREK  WOJSKA CZESKIEGO 43 BRNO 67815143909007671056901333,128,-26732.00
2016-12-21,PRZELEW UZNANIOWY (NADANO 21-12-2016) SK£ADKA CZ£ONKOWSKA ZA MIESI¥C 12-2016  MAREK CZARNOWSKI  WOJSKA CZESKIEGO 43 BRNO 48273508564128540608781731,64,-26796.00
2016-12-23,PRZELEW UZNANIOWY (NADANO 23-12-2016) SK£ADKA CZ£ONKOWSKA ZA MIESI¥C 12-2016  MAREK CZARNOWSKI  WOJSKA CZESKIEGO 43 BRNO 89536345717793853563319033,16,-26812.00
2016-12-25,PRZELEW OBCI¥¯ENIOWY (NADANO 25-12-2016) COS DO PLACENIA  LOKAL  WOJSKA CZESKIEGO 43 BRNO 03257344504044925300809568,-634,-26178.00
2016-12-25,PRZELEW UZNANIOWY (NADANO 25-12-2016) SK£ADKA CZ£ONKOWSKA ZA MIESI¥C 12-2016  MAREK STAROWSKI  WOJSKA CZESKIEGO 43 BRNO 87850929915165051801999293,32,-26210.00
2016-12-27,PRZELEW UZNANIOWY (NADANO 27-12-2016) SK£ADKA CZ£ONKOWSKA ZA MIESI¥C 12-2016  MICHA£ WARSZAWSKI  WOJSKA CZESKIEGO 43 BRNO 29843857439164410510047951,32,-26242.00
2016-12-29,PRZELEW UZNANIOWY (NADANO 29-12-2016) SK£ADKA CZ£ONKOWSKA ZA MIESI¥C 12-2016  STANIS£AW OWCZAREK  WOJSKA CZESKIEGO 43 BRNO 66249037990972153491804453,32,-26274.00
2016-12-31,PRZELEW UZNANIOWY (NADANO 31-12-2016) SK£ADKA CZ£ONKOWSKA ZA MIESI¥C 12-2016  MICHA£ KOWALSKI  WOJSKA CZESKIEGO 43 BRNO 94654012448210481979036685,128,-26402.00
2016-12-31,PRZELEW UZNANIOWY (NADANO 31-12-2016) SK£ADKA CZ£ONKOWSKA ZA MIESI¥C 12-2016  STANIS£AW MARKOWSKI  WOJSKA CZESKIEGO 43 BRNO 65195288895341281463163248,16,-26418.00
2017-01-01,PRZELEW OBCI¥¯ENIOWY (NADANO 01-01-2017) COS DO PLACENIA  TAURON  WOJSKA CZESKIEGO 43 BRNO 41436629876127954274496687,-284,-26134.00
2017-01-02,PRZELEW UZNANIOWY (NADANO 02-01-2017) SK£ADKA CZ£ONKOWSKA ZA MIESI¥C 01-2017  MAREK NOWAK  WOJSKA CZESKIEGO 43 BRNO 30962019975198852465891717,16,-26150.00
2017-01-02,PRZELEW UZNANIOWY (NADANO 02-01-2017) SK£ADKA CZ£ONKOWSKA ZA MIESI¥C 01-2017  MICHA£ CZARNOWSKI  WOJSKA CZESKIEGO 43 BRNO 84632216257701493565691700,128,-26278.00
2017-01-04,PRZELEW UZNANIOWY (NADANO 04-01-2017) DAROWIZNA  DAREK NOWAK  WOJSKA CZESKIEGO 43 BRNO 77689148467938259318182673,772,-27050.00
2017-01-05,PRZELEW UZNANIOWY (NADANO 05-01-2017) SK£ADKA CZ£ONKOWSKA ZA MIESI¥C 01-2017  BARTUŒ CZARNOWSKI  WOJSKA CZESKIEGO 43 BRNO 25875924901031752784357687,32,-27082.00
2017-01-07,PRZELEW UZNANIOWY (NADANO 07-01-2017) DAROWIZNA  £UKASZ STAROWSKI  WOJSKA CZESKIEGO 43 BRNO 70387602119012232306464192,355,-27437.00
2017-01-09,PRZELEW UZNANIOWY (NADANO 09-01-2017) SK£ADKA CZ£ONKOWSKA ZA MIESI¥C 01-2017  HENRYK CHOLERAWIECKI  WOJSKA CZESKIEGO 43 BRNO 80076374103621480512801564,32,-27469.00
2017-01-10,PRZELEW UZNANIOWY (NADANO 10-01-2017) SK£ADKA CZ£ONKOWSKA ZA MIESI¥C 01-2017  BARTUŒ TESTOWSKI  WOJSKA CZESKIEGO 43 BRNO 14586294714011632545440785,32,-27501.00
2017-01-12,PRZELEW UZNANIOWY (NADANO 12-01-2017) SK£ADKA CZ£ONKOWSKA ZA MIESI¥C 01-2017  MICHA£ KOWALSKI  WOJSKA CZESKIEGO 43 BRNO 48551843609644591890636654,16,-27517.00
2017-01-14,PRZELEW UZNANIOWY (NADANO 14-01-2017) SK£ADKA CZ£ONKOWSKA ZA MIESI¥C 01-2017  BARTUŒ TESTOWSKI  WOJSKA CZESKIEGO 43 BRNO 11534426286607621900211167,128,-27645.00
2017-01-15,PRZELEW OBCI¥¯ENIOWY (NADANO 15-01-2017) COS DO PLACENIA  UPC  WOJSKA CZESKIEGO 43 BRNO 22578793611003066243998506,-835,-26810.00
2017-01-16,PRZELEW UZNANIOWY (NADANO 16-01-2017) SK£ADKA CZ£ONKOWSKA ZA MIESI¥C 01-2017  DAREK NOWAK  WOJSKA CZESKIEGO 43 BRNO 44098203062939140825909793,64,-26874.00
2017-01-18,PRZELEW UZNANIOWY (NADANO 18-01-2017) DAROWIZNA  HENRYK KOWALSKI  WOJSKA CZESKIEGO 43 BRNO 44161282902115583804351164,450,-27324.00
2017-01-20,PRZELEW UZNANIOWY (NADANO 20-01-2017) SK£ADKA CZ£ONKOWSKA ZA MIESI¥C 01-2017  MICHA£ KOWALSKI  WOJSKA CZESKIEGO 43 BRNO 47703621291098413685218077,64,-27388.00
2017-01-20,PRZELEW UZNANIOWY (NADANO 20-01-2017) SK£ADKA CZ£ONKOWSKA ZA MIESI¥C 01-2017  BARTUŒ TESTOWSKI  WOJSKA CZESKIEGO 43 BRNO 47181399195668865481875973,16,-27404.00
2017-01-22,PRZELEW UZNANIOWY (NADANO 22-01-2017) SK£ADKA CZ£ONKOWSKA ZA MIESI¥C 01-2017  MICHA£ CZARNOWSKI  WOJSKA CZESKIEGO 43 BRNO 70217595531133031730364509,64,-27468.00
2017-01-23,PRZELEW UZNANIOWY (NADANO 23-01-2017) SK£ADKA CZ£ONKOWSKA ZA MIESI¥C 01-2017  MAREK TESTOWSKI  WOJSKA CZESKIEGO 43 BRNO 15643488995276758831274667,16,-27484.00
2017-01-25,PRZELEW UZNANIOWY (NADANO 25-01-2017) SK£ADKA CZ£ONKOWSKA ZA MIESI¥C 01-2017  STANIS£AW OWCZAREK  WOJSKA CZESKIEGO 43 BRNO 39866646704879697679508927,16,-27500.00
2017-01-25,PRZELEW UZNANIOWY (NADANO 25-01-2017) SK£ADKA CZ£ONKOWSKA ZA MIESI¥C 01-2017  OKTAWIAN PROSTACKI  WOJSKA CZESKIEGO 43 BRNO 49000183573144105949697485,16,-27516.00
2017-01-26,PRZELEW UZNANIOWY (NADANO 26-01-2017) SK£ADKA CZ£ONKOWSKA ZA MIESI¥C 01-2017  BARTUŒ CZARNOWSKI  WOJSKA CZESKIEGO 43 BRNO 23863556610733092079276282,32,-27548.00
2017-01-28,PRZELEW UZNANIOWY (NADANO 28-01-2017) SK£ADKA CZ£ONKOWSKA ZA MIESI¥C 01-2017  DAWID RYBSKI  WOJSKA CZESKIEGO 43 BRNO 05394926992444587272747228,128,-27676.00
2017-01-30,PRZELEW UZNANIOWY (NADANO 30-01-2017) SK£ADKA CZ£ONKOWSKA ZA MIESI¥C 01-2017  £UKASZ NOWAK  WOJSKA CZESKIEGO 43 BRNO 32502766775465658905880382,16,-27692.00
2017-02-01,PRZELEW UZNANIOWY (NADANO 01-02-2017) SK£ADKA CZ£ONKOWSKA ZA MIESI¥C 02-2017  OKTAWIAN RYBSKI  WOJSKA CZESKIEGO 43 BRNO 36187390689914944650672157,32,-27724.00
2017-02-02,PRZELEW UZNANIOWY (NADANO 02-02-2017) SK£ADKA CZ£ONKOWSKA ZA MIESI¥C 02-2017  HENRYK CHOLERAWIECKI  WOJSKA CZESKIEGO 43 BRNO 16274515931163810698450834,64,-27788.00
2017-02-03,PRZELEW UZNANIOWY (NADANO 03-02-2017) SK£ADKA CZ£ONKOWSKA ZA MIESI¥C 02-2017  OKTAWIAN NOWAK  WOJSKA CZESKIEGO 43 BRNO 36230660805211794933575959,32,-27820.00
2017-02-05,PRZELEW OBCI¥¯ENIOWY (NADANO 05-02-2017) COS DO PLACENIA  UPC  WOJSKA CZESKIEGO 43 BRNO 11422280728464937128060595,-1008,-26812.00
2017-02-06,PRZELEW UZNANIOWY (NADANO 06-02-2017) SK£ADKA CZ£ONKOWSKA ZA MIESI¥C 02-2017  PAWE£ KOWALSKI  WOJSKA CZESKIEGO 43 BRNO 26813343206332435033537782,32,-26844.00
2017-02-07,PRZELEW OBCI¥¯ENIOWY (NADANO 07-02-2017) COS DO PLACENIA  LOKAL  WOJSKA CZESKIEGO 43 BRNO 28710686179076760986335622,-464,-26380.00
2017-02-07,PRZELEW UZNANIOWY (NADANO 07-02-2017) SK£ADKA CZ£ONKOWSKA ZA MIESI¥C 02-2017  MAREK TESTOWSKI  WOJSKA CZESKIEGO 43 BRNO 95818147545714861176893363,32,-26412.00
2017-02-08,PRZELEW OBCI¥¯ENIOWY (NADANO 08-02-2017) COS DO PLACENIA  TAURON  WOJSKA CZESKIEGO 43 BRNO 79906800887287328279487422,-704,-25708.00
2017-02-09,PRZELEW UZNANIOWY (NADANO 09-02-2017) SK£ADKA CZ£ONKOWSKA ZA MIESI¥C 02-2017  £UKASZ WARSZAWSKI  WOJSKA CZESKIEGO 43 BRNO 53263096123049814479182699,128,-25836.00
2017-02-10,PRZELEW UZNANIOWY (NADANO 10-02-2017) SK£ADKA CZ£ONKOWSKA ZA MIESI¥C 02-2017  £UKASZ STAROWSKI  WOJSKA CZESKIEGO 43 BRNO 03214376240268776969857361,32,-25868.00
2017-02-11,PRZELEW UZNANIOWY (NADANO 11-02-2017) SK£ADKA CZ£ONKOWSKA ZA MIESI¥C 02-2017  MAREK TESTOWSKI  WOJSKA CZESKIEGO 43 BRNO 90129068813538023454138944,64,-25932.00
2017-02-13,PRZELEW UZNANIOWY (NADANO 13-02-2017) SK£ADKA CZ£ONKOWSKA ZA MIESI¥C 02-2017  OKTAWIAN NOWAK  WOJSKA CZESKIEGO 43 BRNO 51354450897029037180483113,128,-26060.00
2017-02-15,PRZELEW OBCI¥¯ENIOWY (NADANO 15-02-2017) COS DO PLACENIA  TAURON  WOJSKA CZESKIEGO 43 BRNO 53003365364844800415559723,-983,-25077.00
2017-02-17,PRZELEW UZNANIOWY (NADANO 17-02-2017) SK£ADKA CZ£ONKOWSKA ZA MIESI¥C 02-2017  BARTUŒ TESTOWSKI  WOJSKA CZESKIEGO 43 BRNO 36359831011137585059208559,32,-25109.00
2017-02-17,PRZELEW UZNANIOWY (NADANO 17-02-2017) DAROWIZNA  MAREK TESTOWSKI  WOJSKA CZESKIEGO 43 BRNO 83465227252169984241580125,315,-25424.00
2017-02-18,PRZELEW UZNANIOWY (NADANO 18-02-2017) SK£ADKA CZ£ONKOWSKA ZA MIESI¥C 02-2017  OKTAWIAN PROSTACKI  WOJSKA CZESKIEGO 43 BRNO 57545775243187441378793344,64,-25488.00
2017-02-19,PRZELEW OBCI¥¯ENIOWY (NADANO 19-02-2017) COS DO PLACENIA  UPC  WOJSKA CZESKIEGO 43 BRNO 03520571262033745075566661,-512,-24976.00
2017-02-21,PRZELEW UZNANIOWY (NADANO 21-02-2017) SK£ADKA CZ£ONKOWSKA ZA MIESI¥C 02-2017  DAWID RYBSKI  WOJSKA CZESKIEGO 43 BRNO 85206722413297335292317485,16,-24992.00
2017-02-23,PRZELEW UZNANIOWY (NADANO 23-02-2017) DAROWIZNA  STANIS£AW WARSZAWSKI  WOJSKA CZESKIEGO 43 BRNO 15268125459621433731720932,335,-25327.00
2017-02-25,PRZELEW UZNANIOWY (NADANO 25-02-2017) SK£ADKA CZ£ONKOWSKA ZA MIESI¥C 02-2017  MAREK TESTOWSKI  WOJSKA CZESKIEGO 43 BRNO 68637480947313003302590293,32,-25359.00
2017-02-26,PRZELEW UZNANIOWY (NADANO 26-02-2017) SK£ADKA CZ£ONKOWSKA ZA MIESI¥C 02-2017  BARTUŒ TESTOWSKI  WOJSKA CZESKIEGO 43 BRNO 99916117916353286555855391,128,-25487.00
2017-02-28,PRZELEW UZNANIOWY (NADANO 28-02-2017) SK£ADKA CZ£ONKOWSKA ZA MIESI¥C 02-2017  £UKASZ STAROWSKI  WOJSKA CZESKIEGO 43 BRNO 49992052068262626745563806,32,-25519.00
2017-03-01,PRZELEW UZNANIOWY (NADANO 01-03-2017) SK£ADKA CZ£ONKOWSKA ZA MIESI¥C 03-2017  STANIS£AW MARKOWSKI  WOJSKA CZESKIEGO 43 BRNO 91427437594275740707845977,128,-25647.00
2017-03-03,PRZELEW UZNANIOWY (NADANO 03-03-2017) DAROWIZNA  OKTAWIAN NOWAK  WOJSKA CZESKIEGO 43 BRNO 28342613354866431798592423,474,-26121.00
2017-03-04,PRZELEW UZNANIOWY (NADANO 04-03-2017) SK£ADKA CZ£ONKOWSKA ZA MIESI¥C 03-2017  OKTAWIAN RYBSKI  WOJSKA CZESKIEGO 43 BRNO 22556305969033012781622571,128,-26249.00
2017-03-05,PRZELEW UZNANIOWY (NADANO 05-03-2017) SK£ADKA CZ£ONKOWSKA ZA MIESI¥C 03-2017  £UKASZ WARSZAWSKI  WOJSKA CZESKIEGO 43 BRNO 04463597485519026900147434,64,-26313.00
2017-03-06,PRZELEW UZNANIOWY (NADANO 06-03-2017) SK£ADKA CZ£ONKOWSKA ZA MIESI¥C 03-2017  STANIS£AW OWCZAREK  WOJSKA CZESKIEGO 43 BRNO 04467438996776377986089106,128,-26441.00
2017-03-06,PRZELEW UZNANIOWY (NADANO 06-03-2017) SK£ADKA CZ£ONKOWSKA ZA MIESI¥C 03-2017  DAWID RYBSKI  WOJSKA CZESKIEGO 43 BRNO 81151782162062180454639207,16,-26457.00
2017-03-07,PRZELEW UZNANIOWY (NADANO 07-03-2017) DAROWIZNA  MAREK STAROWSKI  WOJSKA CZESKIEGO 43 BRNO 14140892794413358649159250,529,-26986.00
2017-03-09,PRZELEW UZNANIOWY (NADANO 09-03-2017) SK£ADKA CZ£ONKOWSKA ZA MIESI¥C 03-2017  PAWE£ KOWALSKI  WOJSKA CZESKIEGO 43 BRNO 14868473417953720649949833,128,-27114.00
2017-03-10,PRZELEW UZNANIOWY (NADANO 10-03-2017) SK£ADKA CZ£ONKOWSKA ZA MIESI¥C 03-2017  MAREK NOWAK  WOJSKA CZESKIEGO 43 BRNO 26933844846266395976923400,32,-27146.00
2017-03-12,PRZELEW UZNANIOWY (NADANO 12-03-2017) SK£ADKA CZ£ONKOWSKA ZA MIESI¥C 03-2017  MAREK STAROWSKI  WOJSKA CZESKIEGO 43 BRNO 81798060191551314253573307,32,-27178.00
2017-03-12,PRZELEW UZNANIOWY (NADANO 12-03-2017) SK£ADKA CZ£ONKOWSKA ZA MIESI¥C 03-2017  £UKASZ WARSZAWSKI  WOJSKA CZESKIEGO 43 BRNO 77297000758493915298472420,128,-27306.00
2017-03-13,PRZELEW UZNANIOWY (NADANO 13-03-2017) SK£ADKA CZ£ONKOWSKA ZA MIESI¥C 03-2017  OKTAWIAN PROSTACKI  WOJSKA CZESKIEGO 43 BRNO 52494488796867892218437265,128,-27434.00
2017-03-13,PRZELEW UZNANIOWY (NADANO 13-03-2017) SK£ADKA CZ£ONKOWSKA ZA MIESI¥C 03-2017  DAREK NOWAK  WOJSKA CZESKIEGO 43 BRNO 66966157547697826462485343,64,-27498.00
2017-03-13,PRZELEW UZNANIOWY (NADANO 13-03-2017) SK£ADKA CZ£ONKOWSKA ZA MIESI¥C 03-2017  MICHA£ WARSZAWSKI  WOJSKA CZESKIEGO 43 BRNO 60314414050588706656309666,32,-27530.00
2017-03-15,PRZELEW UZNANIOWY (NADANO 15-03-2017) SK£ADKA CZ£ONKOWSKA ZA MIESI¥C 03-2017  MAREK CZARNOWSKI  WOJSKA CZESKIEGO 43 BRNO 68667487289918617662453173,64,-27594.00
2017-03-17,PRZELEW UZNANIOWY (NADANO 17-03-2017) SK£ADKA CZ£ONKOWSKA ZA MIESI¥C 03-2017  £UKASZ NOWAK  WOJSKA CZESKIEGO 43 BRNO 22353047364051776275765653,128,-27722.00
2017-03-19,PRZELEW UZNANIOWY (NADANO 19-03-2017) DAROWIZNA  STANIS£AW WARSZAWSKI  WOJSKA CZESKIEGO 43 BRNO 34734133070343140425508213,336,-28058.00
2017-03-20,PRZELEW UZNANIOWY (NADANO 20-03-2017) SK£ADKA CZ£ONKOWSKA ZA MIESI¥C 03-2017  STANIS£AW CZARNOWSKI  WOJSKA CZESKIEGO 43 BRNO 15719720828557506233657587,32,-28090.00
2017-03-22,PRZELEW OBCI¥¯ENIOWY (NADANO 22-03-2017) COS DO PLACENIA  LOKAL  WOJSKA CZESKIEGO 43 BRNO 76009294856954062809633853,-604,-27486.00
2017-03-22,PRZELEW UZNANIOWY (NADANO 22-03-2017) SK£ADKA CZ£ONKOWSKA ZA MIESI¥C 03-2017  STANIS£AW CZARNOWSKI  WOJSKA CZESKIEGO 43 BRNO 10242163410800936542752769,64,-27550.00
2017-03-23,PRZELEW OBCI¥¯ENIOWY (NADANO 23-03-2017) COS DO PLACENIA  UPC  WOJSKA CZESKIEGO 43 BRNO 80622134032526556768467302,-983,-26567.00
2017-03-23,PRZELEW UZNANIOWY (NADANO 23-03-2017) SK£ADKA CZ£ONKOWSKA ZA MIESI¥C 03-2017  BARTUŒ CZARNOWSKI  WOJSKA CZESKIEGO 43 BRNO 55079654443519760677432288,16,-26583.00
2017-03-25,PRZELEW OBCI¥¯ENIOWY (NADANO 25-03-2017) COS DO PLACENIA  LOKAL  WOJSKA CZESKIEGO 43 BRNO 92689548969221604112176572,-669,-25914.00
2017-03-27,PRZELEW UZNANIOWY (NADANO 27-03-2017) SK£ADKA CZ£ONKOWSKA ZA MIESI¥C 03-2017  £UKASZ NOWAK  WOJSKA CZESKIEGO 43 BRNO 79913482227935402527753225,128,-26042.00
2017-03-29,PRZELEW UZNANIOWY (NADANO 29-03-2017) SK£ADKA CZ£ONKOWSKA ZA MIESI¥C 03-2017  MAREK TESTOWSKI  WOJSKA CZESKIEGO 43 BRNO 95012863813291726938760357,128,-26170.00
2017-03-29,PRZELEW UZNANIOWY (NADANO 29-03-2017) SK£ADKA CZ£ONKOWSKA ZA MIESI¥C 03-2017  MICHA£ KOWALSKI  WOJSKA CZESKIEGO 43 BRNO 19466253963489586172889487,32,-26202.00
2017-03-29,PRZELEW UZNANIOWY (NADANO 29-03-2017) SK£ADKA CZ£ONKOWSKA ZA MIESI¥C 03-2017  MAREK CZARNOWSKI  WOJSKA CZESKIEGO 43 BRNO 79272179441548592799259545,32,-26234.00
2017-03-30,PRZELEW OBCI¥¯ENIOWY (NADANO 30-03-2017) COS DO PLACENIA  LOKAL  WOJSKA CZESKIEGO 43 BRNO 89196842062724358555660434,-703,-25531.00
2017-03-30,PRZELEW UZNANIOWY (NADANO 30-03-2017) SK£ADKA CZ£ONKOWSKA ZA MIESI¥C 03-2017  DAWID MARKOWSKI  WOJSKA CZESKIEGO 43 BRNO 18963075254490669393044850,64,-25595.00
2017-03-31,PRZELEW UZNANIOWY (NADANO 31-03-2017) SK£ADKA CZ£ONKOWSKA ZA MIESI¥C 03-2017  BARTUŒ NOWAK  WOJSKA CZESKIEGO 43 BRNO 94387889854404121210935509,128,-25723.00
2017-04-01,PRZELEW UZNANIOWY (NADANO 01-04-2017) DAROWIZNA  STANIS£AW WARSZAWSKI  WOJSKA CZESKIEGO 43 BRNO 49072272945160377119283815,1021,-26744.00
2017-04-03,PRZELEW UZNANIOWY (NADANO 03-04-2017) DAROWIZNA  £UKASZ WARSZAWSKI  WOJSKA CZESKIEGO 43 BRNO 71892884009710497520353588,457,-27201.00
2017-04-03,PRZELEW UZNANIOWY (NADANO 03-04-2017) SK£ADKA CZ£ONKOWSKA ZA MIESI¥C 04-2017  BARTUŒ NOWAK  WOJSKA CZESKIEGO 43 BRNO 57658919484567611553795366,64,-27265.00
2017-04-05,PRZELEW UZNANIOWY (NADANO 05-04-2017) SK£ADKA CZ£ONKOWSKA ZA MIESI¥C 04-2017  DAWID NOWAK  WOJSKA CZESKIEGO 43 BRNO 98484422017495073172890435,16,-27281.00
2017-04-06,PRZELEW OBCI¥¯ENIOWY (NADANO 06-04-2017) COS DO PLACENIA  LOKAL  WOJSKA CZESKIEGO 43 BRNO 09889888704410359624477980,-850,-26431.00
2017-04-06,PRZELEW UZNANIOWY (NADANO 06-04-2017) SK£ADKA CZ£ONKOWSKA ZA MIESI¥C 04-2017  MAREK STAROWSKI  WOJSKA CZESKIEGO 43 BRNO 60070764143040937620564925,16,-26447.00
2017-04-08,PRZELEW UZNANIOWY (NADANO 08-04-2017) SK£ADKA CZ£ONKOWSKA ZA MIESI¥C 04-2017  OKTAWIAN NOWAK  WOJSKA CZESKIEGO 43 BRNO 77704594259533656640447923,16,-26463.00
2017-04-10,PRZELEW UZNANIOWY (NADANO 10-04-2017) DAROWIZNA  MAREK CZARNOWSKI  WOJSKA CZESKIEGO 43 BRNO 35535215249795017216875816,389,-26852.00
2017-04-11,PRZELEW UZNANIOWY (NADANO 11-04-2017) DAROWIZNA  DAREK NOWAK  WOJSKA CZESKIEGO 43 BRNO 26862713860219735267738103,375,-27227.00
2017-04-11,PRZELEW UZNANIOWY (NADANO 11-04-2017) SK£ADKA CZ£ONKOWSKA ZA MIESI¥C 04-2017  DAWID MARKOWSKI  WOJSKA CZESKIEGO 43 BRNO 45962051632409206329770428,128,-27355.00
2017-04-13,PRZELEW UZNANIOWY (NADANO 13-04-2017) SK£ADKA CZ£ONKOWSKA ZA MIESI¥C 04-2017  STANIS£AW OWCZAREK  WOJSKA CZESKIEGO 43 BRNO 07394497468496610924046710,64,-27419.00
2017-04-15,PRZELEW UZNANIOWY (NADANO 15-04-2017) SK£ADKA CZ£ONKOWSKA ZA MIESI¥C 04-2017  MAREK OWCZAREK  WOJSKA CZESKIEGO 43 BRNO 53503733995103941403296368,128,-27547.00
2017-04-17,PRZELEW UZNANIOWY (NADANO 17-04-2017) SK£ADKA CZ£ONKOWSKA ZA MIESI¥C 04-2017  MICHA£ KOWALSKI  WOJSKA CZESKIEGO 43 BRNO 01909959022974946436547208,64,-27611.00
2017-04-18,PRZELEW UZNANIOWY (NADANO 18-04-2017) SK£ADKA CZ£ONKOWSKA ZA MIESI¥C 04-2017  £UKASZ WARSZAWSKI  WOJSKA CZESKIEGO 43 BRNO 96079055908248350065077018,128,-27739.00
2017-04-18,PRZELEW UZNANIOWY (NADANO 18-04-2017) SK£ADKA CZ£ONKOWSKA ZA MIESI¥C 04-2017  DAWID RYBSKI  WOJSKA CZESKIEGO 43 BRNO 48609414718397469863847524,32,-27771.00
2017-04-20,PRZELEW UZNANIOWY (NADANO 20-04-2017) SK£ADKA CZ£ONKOWSKA ZA MIESI¥C 04-2017  MAREK NOWAK  WOJSKA CZESKIEGO 43 BRNO 17284538619788491603778028,128,-27899.00
2017-04-20,PRZELEW UZNANIOWY (NADANO 20-04-2017) SK£ADKA CZ£ONKOWSKA ZA MIESI¥C 04-2017  BARTUŒ CZARNOWSKI  WOJSKA CZESKIEGO 43 BRNO 11614919258998794520763750,32,-27931.00
2017-04-20,PRZELEW UZNANIOWY (NADANO 20-04-2017) SK£ADKA CZ£ONKOWSKA ZA MIESI¥C 04-2017  DAREK NOWAK  WOJSKA CZESKIEGO 43 BRNO 73556907737998750287731825,16,-27947.00
2017-04-20,PRZELEW UZNANIOWY (NADANO 20-04-2017) SK£ADKA CZ£ONKOWSKA ZA MIESI¥C 04-2017  HENRYK KOWALSKI  WOJSKA CZESKIEGO 43 BRNO 71408357941025663145847681,128,-28075.00
2017-04-22,PRZELEW UZNANIOWY (NADANO 22-04-2017) SK£ADKA CZ£ONKOWSKA ZA MIESI¥C 04-2017  MAREK CZARNOWSKI  WOJSKA CZESKIEGO 43 BRNO 04704375279070775985571042,16,-28091.00
2017-04-24,PRZELEW UZNANIOWY (NADANO 24-04-2017) SK£ADKA CZ£ONKOWSKA ZA MIESI¥C 04-2017  DAWID RYBSKI  WOJSKA CZESKIEGO 43 BRNO 57590138508566480191790699,32,-28123.00
2017-04-24,PRZELEW UZNANIOWY (NADANO 24-04-2017) SK£ADKA CZ£ONKOWSKA ZA MIESI¥C 04-2017  MICHA£ WARSZAWSKI  WOJSKA CZESKIEGO 43 BRNO 34465306146528541927503248,64,-28187.00
2017-04-26,PRZELEW UZNANIOWY (NADANO 26-04-2017) SK£ADKA CZ£ONKOWSKA ZA MIESI¥C 04-2017  PAWE£ NOWAK  WOJSKA CZESKIEGO 43 BRNO 39359878553254932129094473,32,-28219.00
2017-04-28,PRZELEW UZNANIOWY (NADANO 28-04-2017) SK£ADKA CZ£ONKOWSKA ZA MIESI¥C 04-2017  MAREK CZARNOWSKI  WOJSKA CZESKIEGO 43 BRNO 16539295163802191140806486,32,-28251.00
2017-04-28,PRZELEW UZNANIOWY (NADANO 28-04-2017) SK£ADKA CZ£ONKOWSKA ZA MIESI¥C 04-2017  STANIS£AW OWCZAREK  WOJSKA CZESKIEGO 43 BRNO 55878322756119363473163830,16,-28267.00
2017-04-28,PRZELEW UZNANIOWY (NADANO 28-04-2017) SK£ADKA CZ£ONKOWSKA ZA MIESI¥C 04-2017  MICHA£ CZARNOWSKI  WOJSKA CZESKIEGO 43 BRNO 24590312221537012824174144,128,-28395.00
2017-04-30,PRZELEW OBCI¥¯ENIOWY (NADANO 30-04-2017) COS DO PLACENIA  LOKAL  WOJSKA CZESKIEGO 43 BRNO 91140982804029609716739686,-934,-27461.00
2017-05-02,PRZELEW UZNANIOWY (NADANO 02-05-2017) SK£ADKA CZ£ONKOWSKA ZA MIESI¥C 05-2017  £UKASZ NOWAK  WOJSKA CZESKIEGO 43 BRNO 21009171124591573761294428,32,-27493.00
2017-05-02,PRZELEW UZNANIOWY (NADANO 02-05-2017) SK£ADKA CZ£ONKOWSKA ZA MIESI¥C 05-2017  BARTUŒ CZARNOWSKI  WOJSKA CZESKIEGO 43 BRNO 14690243626915027064981312,128,-27621.00
2017-05-03,PRZELEW UZNANIOWY (NADANO 03-05-2017) SK£ADKA CZ£ONKOWSKA ZA MIESI¥C 05-2017  MICHA£ KOWALSKI  WOJSKA CZESKIEGO 43 BRNO 06701999555670239890254718,32,-27653.00
2017-05-05,PRZELEW UZNANIOWY (NADANO 05-05-2017) SK£ADKA CZ£ONKOWSKA ZA MIESI¥C 05-2017  DAWID MARKOWSKI  WOJSKA CZESKIEGO 43 BRNO 41546454808571903830403796,32,-27685.00
2017-05-07,PRZELEW UZNANIOWY (NADANO 07-05-2017) SK£ADKA CZ£ONKOWSKA ZA MIESI¥C 05-2017  £UKASZ NOWAK  WOJSKA CZESKIEGO 43 BRNO 63569098935009379274408044,128,-27813.00
2017-05-07,PRZELEW UZNANIOWY (NADANO 07-05-2017) SK£ADKA CZ£ONKOWSKA ZA MIESI¥C 05-2017  MICHA£ KOWALSKI  WOJSKA CZESKIEGO 43 BRNO 31534231565977846867353997,64,-27877.00
2017-05-08,PRZELEW UZNANIOWY (NADANO 08-05-2017) SK£ADKA CZ£ONKOWSKA ZA MIESI¥C 05-2017  MAREK CZARNOWSKI  WOJSKA CZESKIEGO 43 BRNO 81616338359667961926180262,64,-27941.00
2017-05-09,PRZELEW UZNANIOWY (NADANO 09-05-2017) SK£ADKA CZ£ONKOWSKA ZA MIESI¥C 05-2017  PAWE£ KOWALSKI  WOJSKA CZESKIEGO 43 BRNO 12854709352173906944773275,128,-28069.00
2017-05-11,PRZELEW UZNANIOWY (NADANO 11-05-2017) SK£ADKA CZ£ONKOWSKA ZA MIESI¥C 05-2017  £UKASZ STAROWSKI  WOJSKA CZESKIEGO 43 BRNO 19615435621827766301064302,128,-28197.00
2017-05-12,PRZELEW UZNANIOWY (NADANO 12-05-2017) SK£ADKA CZ£ONKOWSKA ZA MIESI¥C 05-2017  £UKASZ WARSZAWSKI  WOJSKA CZESKIEGO 43 BRNO 16559852389705639436760324,128,-28325.00
2017-05-12,PRZELEW UZNANIOWY (NADANO 12-05-2017) SK£ADKA CZ£ONKOWSKA ZA MIESI¥C 05-2017  MAREK NOWAK  WOJSKA CZESKIEGO 43 BRNO 99005345333332688163339712,128,-28453.00
2017-05-12,PRZELEW UZNANIOWY (NADANO 12-05-2017) SK£ADKA CZ£ONKOWSKA ZA MIESI¥C 05-2017  £UKASZ STAROWSKI  WOJSKA CZESKIEGO 43 BRNO 56855364468019966847842921,128,-28581.00
2017-05-14,PRZELEW OBCI¥¯ENIOWY (NADANO 14-05-2017) COS DO PLACENIA  TAURON  WOJSKA CZESKIEGO 43 BRNO 25154735717487898428979339,-752,-27829.00
2017-05-14,PRZELEW UZNANIOWY (NADANO 14-05-2017) SK£ADKA CZ£ONKOWSKA ZA MIESI¥C 05-2017  MAREK TESTOWSKI  WOJSKA CZESKIEGO 43 BRNO 30361382112629474708981157,16,-27845.00
2017-05-15,PRZELEW UZNANIOWY (NADANO 15-05-2017) SK£ADKA CZ£ONKOWSKA ZA MIESI¥C 05-2017  MAREK OWCZAREK  WOJSKA CZESKIEGO 43 BRNO 77615379697478734420633010,32,-27877.00
2017-05-16,PRZELEW UZNANIOWY (NADANO 16-05-2017) SK£ADKA CZ£ONKOWSKA ZA MIESI¥C 05-2017  MAREK CZARNOWSKI  WOJSKA CZESKIEGO 43 BRNO 70571487436737862696206206,32,-27909.00
2017-05-18,PRZELEW UZNANIOWY (NADANO 18-05-2017) SK£ADKA CZ£ONKOWSKA ZA MIESI¥C 05-2017  MICHA£ WARSZAWSKI  WOJSKA CZESKIEGO 43 BRNO 04880459160614917983044411,32,-27941.00
2017-05-18,PRZELEW UZNANIOWY (NADANO 18-05-2017) SK£ADKA CZ£ONKOWSKA ZA MIESI¥C 05-2017  STANIS£AW OWCZAREK  WOJSKA CZESKIEGO 43 BRNO 36576959484942476038482952,64,-28005.00
2017-05-18,PRZELEW UZNANIOWY (NADANO 18-05-2017) SK£ADKA CZ£ONKOWSKA ZA MIESI¥C 05-2017  STANIS£AW OWCZAREK  WOJSKA CZESKIEGO 43 BRNO 39050079550397808171549958,16,-28021.00
2017-05-20,PRZELEW UZNANIOWY (NADANO 20-05-2017) SK£ADKA CZ£ONKOWSKA ZA MIESI¥C 05-2017  MICHA£ CZARNOWSKI  WOJSKA CZESKIEGO 43 BRNO 16788381595053508366498404,128,-28149.00
2017-05-22,PRZELEW UZNANIOWY (NADANO 22-05-2017) SK£ADKA CZ£ONKOWSKA ZA MIESI¥C 05-2017  OKTAWIAN RYBSKI  WOJSKA CZESKIEGO 43 BRNO 61581905360488700792552805,16,-28165.00
2017-05-24,PRZELEW UZNANIOWY (NADANO 24-05-2017) SK£ADKA CZ£ONKOWSKA ZA MIESI¥C 05-2017  OKTAWIAN RYBSKI  WOJSKA CZESKIEGO 43 BRNO 82214239330230980378341036,128,-28293.00
2017-05-25,PRZELEW UZNANIOWY (NADANO 25-05-2017) SK£ADKA CZ£ONKOWSKA ZA MIESI¥C 05-2017  STANIS£AW OWCZAREK  WOJSKA CZESKIEGO 43 BRNO 91882378517433026635454013,16,-28309.00
2017-05-25,PRZELEW UZNANIOWY (NADANO 25-05-2017) SK£ADKA CZ£ONKOWSKA ZA MIESI¥C 05-2017  STANIS£AW MARKOWSKI  WOJSKA CZESKIEGO 43 BRNO 81621162230263005207584924,16,-28325.00
2017-05-25,PRZELEW UZNANIOWY (NADANO 25-05-2017) SK£ADKA CZ£ONKOWSKA ZA MIESI¥C 05-2017  MAREK CZARNOWSKI  WOJSKA CZESKIEGO 43 BRNO 58254240906697626281022979,64,-28389.00
2017-05-25,PRZELEW UZNANIOWY (NADANO 25-05-2017) SK£ADKA CZ£ONKOWSKA ZA MIESI¥C 05-2017  HENRYK CHOLERAWIECKI  WOJSKA CZESKIEGO 43 BRNO 47688758159829032700694044,128,-28517.00
2017-05-25,PRZELEW OBCI¥¯ENIOWY (NADANO 25-05-2017) COS DO PLACENIA  TAURON  WOJSKA CZESKIEGO 43 BRNO 76586320291524199129938848,-262,-28255.00
2017-05-26,PRZELEW UZNANIOWY (NADANO 26-05-2017) SK£ADKA CZ£ONKOWSKA ZA MIESI¥C 05-2017  STANIS£AW WARSZAWSKI  WOJSKA CZESKIEGO 43 BRNO 25513789290386615483697996,32,-28287.00
2017-05-28,PRZELEW UZNANIOWY (NADANO 28-05-2017) DAROWIZNA  BARTUŒ NOWAK  WOJSKA CZESKIEGO 43 BRNO 32075694532270209652621193,810,-29097.00
2017-05-28,PRZELEW UZNANIOWY (NADANO 28-05-2017) SK£ADKA CZ£ONKOWSKA ZA MIESI¥C 05-2017  MAREK STAROWSKI  WOJSKA CZESKIEGO 43 BRNO 33199310582009172590565294,128,-29225.00
2017-05-29,PRZELEW UZNANIOWY (NADANO 29-05-2017) SK£ADKA CZ£ONKOWSKA ZA MIESI¥C 05-2017  STANIS£AW CZARNOWSKI  WOJSKA CZESKIEGO 43 BRNO 30159446670786645759939510,64,-29289.00
2017-05-31,PRZELEW UZNANIOWY (NADANO 31-05-2017) SK£ADKA CZ£ONKOWSKA ZA MIESI¥C 05-2017  STANIS£AW CZARNOWSKI  WOJSKA CZESKIEGO 43 BRNO 87291427733522134009570724,32,-29321.00
2017-06-01,PRZELEW UZNANIOWY (NADANO 01-06-2017) SK£ADKA CZ£ONKOWSKA ZA MIESI¥C 06-2017  DAREK NOWAK  WOJSKA CZESKIEGO 43 BRNO 64103938192870006274962885,64,-29385.00
2017-06-03,PRZELEW UZNANIOWY (NADANO 03-06-2017) SK£ADKA CZ£ONKOWSKA ZA MIESI¥C 06-2017  HENRYK CHOLERAWIECKI  WOJSKA CZESKIEGO 43 BRNO 03772841255477196415112100,16,-29401.00
2017-06-05,PRZELEW UZNANIOWY (NADANO 05-06-2017) SK£ADKA CZ£ONKOWSKA ZA MIESI¥C 06-2017  DAREK NOWAK  WOJSKA CZESKIEGO 43 BRNO 56723243262804051714525625,128,-29529.00
2017-06-06,PRZELEW UZNANIOWY (NADANO 06-06-2017) SK£ADKA CZ£ONKOWSKA ZA MIESI¥C 06-2017  MICHA£ CZARNOWSKI  WOJSKA CZESKIEGO 43 BRNO 65286767269558558533891570,32,-29561.00
2017-06-08,PRZELEW UZNANIOWY (NADANO 08-06-2017) SK£ADKA CZ£ONKOWSKA ZA MIESI¥C 06-2017  HENRYK CHOLERAWIECKI  WOJSKA CZESKIEGO 43 BRNO 23966834828691379323310968,16,-29577.00
2017-06-10,PRZELEW UZNANIOWY (NADANO 10-06-2017) SK£ADKA CZ£ONKOWSKA ZA MIESI¥C 06-2017  OKTAWIAN NOWAK  WOJSKA CZESKIEGO 43 BRNO 42651102259588368037906102,128,-29705.00
2017-06-12,PRZELEW UZNANIOWY (NADANO 12-06-2017) SK£ADKA CZ£ONKOWSKA ZA MIESI¥C 06-2017  STANIS£AW STAROWSKI  WOJSKA CZESKIEGO 43 BRNO 16103058210072728388280984,64,-29769.00
2017-06-14,PRZELEW UZNANIOWY (NADANO 14-06-2017) SK£ADKA CZ£ONKOWSKA ZA MIESI¥C 06-2017  BARTUŒ CZARNOWSKI  WOJSKA CZESKIEGO 43 BRNO 29096926985224039999279075,16,-29785.00
2017-06-14,PRZELEW UZNANIOWY (NADANO 14-06-2017) SK£ADKA CZ£ONKOWSKA ZA MIESI¥C 06-2017  £UKASZ WARSZAWSKI  WOJSKA CZESKIEGO 43 BRNO 41538434464537360455230300,32,-29817.00
2017-06-16,PRZELEW UZNANIOWY (NADANO 16-06-2017) SK£ADKA CZ£ONKOWSKA ZA MIESI¥C 06-2017  OKTAWIAN RYBSKI  WOJSKA CZESKIEGO 43 BRNO 37913338383706888458740116,16,-29833.00
2017-06-17,PRZELEW UZNANIOWY (NADANO 17-06-2017) SK£ADKA CZ£ONKOWSKA ZA MIESI¥C 06-2017  STANIS£AW STAROWSKI  WOJSKA CZESKIEGO 43 BRNO 00086363001118722094716745,32,-29865.00
2017-06-17,PRZELEW UZNANIOWY (NADANO 17-06-2017) SK£ADKA CZ£ONKOWSKA ZA MIESI¥C 06-2017  BARTUŒ TESTOWSKI  WOJSKA CZESKIEGO 43 BRNO 33766895542357388429991071,32,-29897.00
2017-06-19,PRZELEW UZNANIOWY (NADANO 19-06-2017) SK£ADKA CZ£ONKOWSKA ZA MIESI¥C 06-2017  STANIS£AW CZARNOWSKI  WOJSKA CZESKIEGO 43 BRNO 97190715388014805748298470,32,-29929.00
2017-06-21,PRZELEW OBCI¥¯ENIOWY (NADANO 21-06-2017) COS DO PLACENIA  TAURON  WOJSKA CZESKIEGO 43 BRNO 96084443906751304788651164,-785,-29144.00
2017-06-21,PRZELEW UZNANIOWY (NADANO 21-06-2017) SK£ADKA CZ£ONKOWSKA ZA MIESI¥C 06-2017  DAWID RYBSKI  WOJSKA CZESKIEGO 43 BRNO 77295668001241243333729326,64,-29208.00
2017-06-21,PRZELEW UZNANIOWY (NADANO 21-06-2017) SK£ADKA CZ£ONKOWSKA ZA MIESI¥C 06-2017  STANIS£AW OWCZAREK  WOJSKA CZESKIEGO 43 BRNO 47019460586163214407423778,16,-29224.00
2017-06-22,PRZELEW UZNANIOWY (NADANO 22-06-2017) SK£ADKA CZ£ONKOWSKA ZA MIESI¥C 06-2017  PAWE£ KOWALSKI  WOJSKA CZESKIEGO 43 BRNO 93575464750012163742812389,32,-29256.00
2017-06-23,PRZELEW UZNANIOWY (NADANO 23-06-2017) SK£ADKA CZ£ONKOWSKA ZA MIESI¥C 06-2017  DAWID NOWAK  WOJSKA CZESKIEGO 43 BRNO 51527367962889588152250633,16,-29272.00
2017-06-25,PRZELEW UZNANIOWY (NADANO 25-06-2017) SK£ADKA CZ£ONKOWSKA ZA MIESI¥C 06-2017  PAWE£ NOWAK  WOJSKA CZESKIEGO 43 BRNO 19523645238776347737967763,32,-29304.00
2017-06-25,PRZELEW UZNANIOWY (NADANO 25-06-2017) DAROWIZNA  MICHA£ KOWALSKI  WOJSKA CZESKIEGO 43 BRNO 43224124851403886429757207,434,-29738.00
2017-06-27,PRZELEW UZNANIOWY (NADANO 27-06-2017) DAROWIZNA  STANIS£AW OWCZAREK  WOJSKA CZESKIEGO 43 BRNO 98665238123705139618508299,879,-30617.00
2017-06-28,PRZELEW UZNANIOWY (NADANO 28-06-2017) SK£ADKA CZ£ONKOWSKA ZA MIESI¥C 06-2017  HENRYK CHOLERAWIECKI  WOJSKA CZESKIEGO 43 BRNO 15733428429775339589599379,128,-30745.00
2017-06-30,PRZELEW UZNANIOWY (NADANO 30-06-2017) SK£ADKA CZ£ONKOWSKA ZA MIESI¥C 06-2017  MAREK TESTOWSKI  WOJSKA CZESKIEGO 43 BRNO 35854426347149604549541296,16,-30761.00
2017-06-30,PRZELEW UZNANIOWY (NADANO 30-06-2017) SK£ADKA CZ£ONKOWSKA ZA MIESI¥C 06-2017  MICHA£ WARSZAWSKI  WOJSKA CZESKIEGO 43 BRNO 69507541734408323460367026,16,-30777.00
2017-07-02,PRZELEW UZNANIOWY (NADANO 02-07-2017) SK£ADKA CZ£ONKOWSKA ZA MIESI¥C 07-2017  PAWE£ KOWALSKI  WOJSKA CZESKIEGO 43 BRNO 81648654018239231682121719,32,-30809.00
2017-07-03,PRZELEW UZNANIOWY (NADANO 03-07-2017) SK£ADKA CZ£ONKOWSKA ZA MIESI¥C 07-2017  DAREK NOWAK  WOJSKA CZESKIEGO 43 BRNO 62153869797594400389363897,32,-30841.00
2017-07-03,PRZELEW UZNANIOWY (NADANO 03-07-2017) SK£ADKA CZ£ONKOWSKA ZA MIESI¥C 07-2017  £UKASZ NOWAK  WOJSKA CZESKIEGO 43 BRNO 12307369344789980604921980,32,-30873.00
2017-07-03,PRZELEW UZNANIOWY (NADANO 03-07-2017) DAROWIZNA  MAREK NOWAK  WOJSKA CZESKIEGO 43 BRNO 07200138106034268853820772,288,-31161.00
2017-07-05,PRZELEW UZNANIOWY (NADANO 05-07-2017) SK£ADKA CZ£ONKOWSKA ZA MIESI¥C 07-2017  DAWID NOWAK  WOJSKA CZESKIEGO 43 BRNO 69188601392991853504672799,64,-31225.00
2017-07-05,PRZELEW UZNANIOWY (NADANO 05-07-2017) SK£ADKA CZ£ONKOWSKA ZA MIESI¥C 07-2017  BARTUŒ NOWAK  WOJSKA CZESKIEGO 43 BRNO 60048705597141829574495674,32,-31257.00
2017-07-05,PRZELEW UZNANIOWY (NADANO 05-07-2017) SK£ADKA CZ£ONKOWSKA ZA MIESI¥C 07-2017  HENRYK CHOLERAWIECKI  WOJSKA CZESKIEGO 43 BRNO 63183232736700636035616709,128,-31385.00
2017-07-06,PRZELEW OBCI¥¯ENIOWY (NADANO 06-07-2017) COS DO PLACENIA  TAURON  WOJSKA CZESKIEGO 43 BRNO 98668611096176539574310826,-793,-30592.00
2017-07-06,PRZELEW UZNANIOWY (NADANO 06-07-2017) SK£ADKA CZ£ONKOWSKA ZA MIESI¥C 07-2017  BARTUŒ CZARNOWSKI  WOJSKA CZESKIEGO 43 BRNO 17886055486141596374452275,128,-30720.00
2017-07-08,PRZELEW UZNANIOWY (NADANO 08-07-2017) SK£ADKA CZ£ONKOWSKA ZA MIESI¥C 07-2017  STANIS£AW MARKOWSKI  WOJSKA CZESKIEGO 43 BRNO 46896965287488720966765450,64,-30784.00
2017-07-10,PRZELEW UZNANIOWY (NADANO 10-07-2017) SK£ADKA CZ£ONKOWSKA ZA MIESI¥C 07-2017  PAWE£ NOWAK  WOJSKA CZESKIEGO 43 BRNO 33619858582982193736081352,32,-30816.00
2017-07-12,PRZELEW UZNANIOWY (NADANO 12-07-2017) SK£ADKA CZ£ONKOWSKA ZA MIESI¥C 07-2017  £UKASZ WARSZAWSKI  WOJSKA CZESKIEGO 43 BRNO 92489620426257044203420562,128,-30944.00
2017-07-14,PRZELEW UZNANIOWY (NADANO 14-07-2017) SK£ADKA CZ£ONKOWSKA ZA MIESI¥C 07-2017  HENRYK KOWALSKI  WOJSKA CZESKIEGO 43 BRNO 93217894303220056052113279,128,-31072.00
2017-07-14,PRZELEW OBCI¥¯ENIOWY (NADANO 14-07-2017) COS DO PLACENIA  LOKAL  WOJSKA CZESKIEGO 43 BRNO 28028683547608788470597014,-889,-30183.00
2017-07-14,PRZELEW OBCI¥¯ENIOWY (NADANO 14-07-2017) COS DO PLACENIA  UPC  WOJSKA CZESKIEGO 43 BRNO 28939514270541590122055708,-369,-29814.00
2017-07-14,PRZELEW UZNANIOWY (NADANO 14-07-2017) SK£ADKA CZ£ONKOWSKA ZA MIESI¥C 07-2017  DAREK NOWAK  WOJSKA CZESKIEGO 43 BRNO 47500896840790092183058944,64,-29878.00
2017-07-16,PRZELEW UZNANIOWY (NADANO 16-07-2017) SK£ADKA CZ£ONKOWSKA ZA MIESI¥C 07-2017  STANIS£AW OWCZAREK  WOJSKA CZESKIEGO 43 BRNO 33578827883068807610236653,16,-29894.00
2017-07-17,PRZELEW UZNANIOWY (NADANO 17-07-2017) SK£ADKA CZ£ONKOWSKA ZA MIESI¥C 07-2017  MAREK TESTOWSKI  WOJSKA CZESKIEGO 43 BRNO 96289595366173733856929933,64,-29958.00
2017-07-17,PRZELEW OBCI¥¯ENIOWY (NADANO 17-07-2017) COS DO PLACENIA  LOKAL  WOJSKA CZESKIEGO 43 BRNO 91010575438682447005545928,-685,-29273.00
2017-07-19,PRZELEW UZNANIOWY (NADANO 19-07-2017) SK£ADKA CZ£ONKOWSKA ZA MIESI¥C 07-2017  HENRYK KOWALSKI  WOJSKA CZESKIEGO 43 BRNO 57670756929952457091082652,16,-29289.00
2017-07-20,PRZELEW UZNANIOWY (NADANO 20-07-2017) SK£ADKA CZ£ONKOWSKA ZA MIESI¥C 07-2017  MAREK CZARNOWSKI  WOJSKA CZESKIEGO 43 BRNO 55768085038570556081545352,128,-29417.00
2017-07-22,PRZELEW UZNANIOWY (NADANO 22-07-2017) SK£ADKA CZ£ONKOWSKA ZA MIESI¥C 07-2017  £UKASZ WARSZAWSKI  WOJSKA CZESKIEGO 43 BRNO 26235341631778919189751744,64,-29481.00
2017-07-23,PRZELEW OBCI¥¯ENIOWY (NADANO 23-07-2017) COS DO PLACENIA  UPC  WOJSKA CZESKIEGO 43 BRNO 28085362224026026305158824,-300,-29181.00
2017-07-23,PRZELEW UZNANIOWY (NADANO 23-07-2017) SK£ADKA CZ£ONKOWSKA ZA MIESI¥C 07-2017  MICHA£ KOWALSKI  WOJSKA CZESKIEGO 43 BRNO 04729054631326274928193803,32,-29213.00
2017-07-23,PRZELEW UZNANIOWY (NADANO 23-07-2017) DAROWIZNA  MAREK CZARNOWSKI  WOJSKA CZESKIEGO 43 BRNO 02991296386639030170568813,971,-30184.00
2017-07-24,PRZELEW UZNANIOWY (NADANO 24-07-2017) DAROWIZNA  PAWE£ KOWALSKI  WOJSKA CZESKIEGO 43 BRNO 37222379611110829720912032,619,-30803.00
2017-07-24,PRZELEW UZNANIOWY (NADANO 24-07-2017) SK£ADKA CZ£ONKOWSKA ZA MIESI¥C 07-2017  STANIS£AW OWCZAREK  WOJSKA CZESKIEGO 43 BRNO 42005922904811617704891694,16,-30819.00
2017-07-24,PRZELEW UZNANIOWY (NADANO 24-07-2017) SK£ADKA CZ£ONKOWSKA ZA MIESI¥C 07-2017  STANIS£AW WARSZAWSKI  WOJSKA CZESKIEGO 43 BRNO 17368443939010013853438868,128,-30947.00
2017-07-25,PRZELEW OBCI¥¯ENIOWY (NADANO 25-07-2017) COS DO PLACENIA  TAURON  WOJSKA CZESKIEGO 43 BRNO 04718294433167079001578831,-951,-29996.00
2017-07-26,PRZELEW UZNANIOWY (NADANO 26-07-2017) SK£ADKA CZ£ONKOWSKA ZA MIESI¥C 07-2017  £UKASZ STAROWSKI  WOJSKA CZESKIEGO 43 BRNO 32703897605385213797544495,32,-30028.00
2017-07-26,PRZELEW UZNANIOWY (NADANO 26-07-2017) SK£ADKA CZ£ONKOWSKA ZA MIESI¥C 07-2017  DAWID NOWAK  WOJSKA CZESKIEGO 43 BRNO 56284194962374878757583627,32,-30060.00
2017-07-27,PRZELEW UZNANIOWY (NADANO 27-07-2017) SK£ADKA CZ£ONKOWSKA ZA MIESI¥C 07-2017  STANIS£AW MARKOWSKI  WOJSKA CZESKIEGO 43 BRNO 12461006352438736703107032,128,-30188.00
2017-07-28,PRZELEW UZNANIOWY (NADANO 28-07-2017) SK£ADKA CZ£ONKOWSKA ZA MIESI¥C 07-2017  DAWID MARKOWSKI  WOJSKA CZESKIEGO 43 BRNO 28862913645476048431924353,128,-30316.00
2017-07-28,PRZELEW UZNANIOWY (NADANO 28-07-2017) SK£ADKA CZ£ONKOWSKA ZA MIESI¥C 07-2017  MICHA£ WARSZAWSKI  WOJSKA CZESKIEGO 43 BRNO 47339103185706645234252999,64,-30380.00
2017-07-29,PRZELEW UZNANIOWY (NADANO 29-07-2017) SK£ADKA CZ£ONKOWSKA ZA MIESI¥C 07-2017  PAWE£ KOWALSKI  WOJSKA CZESKIEGO 43 BRNO 99563135562040963917432163,16,-30396.00
2017-07-30,PRZELEW UZNANIOWY (NADANO 30-07-2017) SK£ADKA CZ£ONKOWSKA ZA MIESI¥C 07-2017  BARTUŒ CZARNOWSKI  WOJSKA CZESKIEGO 43 BRNO 03544879831634066903503473,16,-30412.00
2017-07-31,PRZELEW OBCI¥¯ENIOWY (NADANO 31-07-2017) COS DO PLACENIA  TAURON  WOJSKA CZESKIEGO 43 BRNO 43654880559240174419936618,-648,-29764.00
2017-07-31,PRZELEW UZNANIOWY (NADANO 31-07-2017) SK£ADKA CZ£ONKOWSKA ZA MIESI¥C 07-2017  MICHA£ CZARNOWSKI  WOJSKA CZESKIEGO 43 BRNO 94430786536588666454726416,64,-29828.00
2017-08-02,PRZELEW UZNANIOWY (NADANO 02-08-2017) SK£ADKA CZ£ONKOWSKA ZA MIESI¥C 08-2017  HENRYK CHOLERAWIECKI  WOJSKA CZESKIEGO 43 BRNO 69166595117165407733986412,32,-29860.00
2017-08-03,PRZELEW UZNANIOWY (NADANO 03-08-2017) SK£ADKA CZ£ONKOWSKA ZA MIESI¥C 08-2017  OKTAWIAN RYBSKI  WOJSKA CZESKIEGO 43 BRNO 35849170830342524684710417,128,-29988.00
2017-08-04,PRZELEW UZNANIOWY (NADANO 04-08-2017) SK£ADKA CZ£ONKOWSKA ZA MIESI¥C 08-2017  BARTUŒ NOWAK  WOJSKA CZESKIEGO 43 BRNO 49944660498023779289979417,64,-30052.00
2017-08-05,PRZELEW UZNANIOWY (NADANO 05-08-2017) SK£ADKA CZ£ONKOWSKA ZA MIESI¥C 08-2017  DAWID NOWAK  WOJSKA CZESKIEGO 43 BRNO 52370313492845033359797514,128,-30180.00
2017-08-05,PRZELEW UZNANIOWY (NADANO 05-08-2017) SK£ADKA CZ£ONKOWSKA ZA MIESI¥C 08-2017  STANIS£AW STAROWSKI  WOJSKA CZESKIEGO 43 BRNO 34416939106520892984628582,128,-30308.00
2017-08-05,PRZELEW UZNANIOWY (NADANO 05-08-2017) SK£ADKA CZ£ONKOWSKA ZA MIESI¥C 08-2017  OKTAWIAN PROSTACKI  WOJSKA CZESKIEGO 43 BRNO 97410364312875036530560149,32,-30340.00
2017-08-07,PRZELEW UZNANIOWY (NADANO 07-08-2017) SK£ADKA CZ£ONKOWSKA ZA MIESI¥C 08-2017  MAREK CZARNOWSKI  WOJSKA CZESKIEGO 43 BRNO 54582422865248282388302640,32,-30372.00
2017-08-09,PRZELEW UZNANIOWY (NADANO 09-08-2017) SK£ADKA CZ£ONKOWSKA ZA MIESI¥C 08-2017  £UKASZ NOWAK  WOJSKA CZESKIEGO 43 BRNO 37445040269741122107162586,32,-30404.00
2017-08-09,PRZELEW UZNANIOWY (NADANO 09-08-2017) SK£ADKA CZ£ONKOWSKA ZA MIESI¥C 08-2017  STANIS£AW CZARNOWSKI  WOJSKA CZESKIEGO 43 BRNO 72707590114137196575882882,128,-30532.00
2017-08-10,PRZELEW UZNANIOWY (NADANO 10-08-2017) SK£ADKA CZ£ONKOWSKA ZA MIESI¥C 08-2017  STANIS£AW STAROWSKI  WOJSKA CZESKIEGO 43 BRNO 77274761252445618716990796,64,-30596.00
2017-08-10,PRZELEW UZNANIOWY (NADANO 10-08-2017) SK£ADKA CZ£ONKOWSKA ZA MIESI¥C 08-2017  BARTUŒ CZARNOWSKI  WOJSKA CZESKIEGO 43 BRNO 57161019081547860617571388,32,-30628.00
2017-08-10,PRZELEW UZNANIOWY (NADANO 10-08-2017) SK£ADKA CZ£ONKOWSKA ZA MIESI¥C 08-2017  BARTUŒ CZARNOWSKI  WOJSKA CZESKIEGO 43 BRNO 33322515839844573413198424,64,-30692.00
2017-08-12,PRZELEW UZNANIOWY (NADANO 12-08-2017) SK£ADKA CZ£ONKOWSKA ZA MIESI¥C 08-2017  STANIS£AW CZARNOWSKI  WOJSKA CZESKIEGO 43 BRNO 71683908930905044537937499,16,-30708.00
2017-08-12,PRZELEW UZNANIOWY (NADANO 12-08-2017) SK£ADKA CZ£ONKOWSKA ZA MIESI¥C 08-2017  MAREK TESTOWSKI  WOJSKA CZESKIEGO 43 BRNO 76585699160732428603175292,64,-30772.00
2017-08-13,PRZELEW UZNANIOWY (NADANO 13-08-2017) SK£ADKA CZ£ONKOWSKA ZA MIESI¥C 08-2017  £UKASZ NOWAK  WOJSKA CZESKIEGO 43 BRNO 15653352560948556880267412,16,-30788.00
2017-08-15,PRZELEW UZNANIOWY (NADANO 15-08-2017) DAROWIZNA  BARTUŒ CZARNOWSKI  WOJSKA CZESKIEGO 43 BRNO 06759943225432283979710825,610,-31398.00
2017-08-17,PRZELEW UZNANIOWY (NADANO 17-08-2017) SK£ADKA CZ£ONKOWSKA ZA MIESI¥C 08-2017  MAREK TESTOWSKI  WOJSKA CZESKIEGO 43 BRNO 68011016651681618716613274,32,-31430.00
2017-08-19,PRZELEW UZNANIOWY (NADANO 19-08-2017) SK£ADKA CZ£ONKOWSKA ZA MIESI¥C 08-2017  £UKASZ STAROWSKI  WOJSKA CZESKIEGO 43 BRNO 67670411698324905025797705,32,-31462.00
2017-08-21,PRZELEW UZNANIOWY (NADANO 21-08-2017) SK£ADKA CZ£ONKOWSKA ZA MIESI¥C 08-2017  £UKASZ WARSZAWSKI  WOJSKA CZESKIEGO 43 BRNO 82137104188027542685759410,128,-31590.00
2017-08-21,PRZELEW UZNANIOWY (NADANO 21-08-2017) SK£ADKA CZ£ONKOWSKA ZA MIESI¥C 08-2017  MICHA£ CZARNOWSKI  WOJSKA CZESKIEGO 43 BRNO 70666413090907517328377277,64,-31654.00
2017-08-23,PRZELEW UZNANIOWY (NADANO 23-08-2017) SK£ADKA CZ£ONKOWSKA ZA MIESI¥C 08-2017  OKTAWIAN RYBSKI  WOJSKA CZESKIEGO 43 BRNO 45586150042030190509365235,128,-31782.00
2017-08-24,PRZELEW UZNANIOWY (NADANO 24-08-2017) SK£ADKA CZ£ONKOWSKA ZA MIESI¥C 08-2017  BARTUŒ NOWAK  WOJSKA CZESKIEGO 43 BRNO 13059143022718517477534915,128,-31910.00
2017-08-26,PRZELEW OBCI¥¯ENIOWY (NADANO 26-08-2017) COS DO PLACENIA  UPC  WOJSKA CZESKIEGO 43 BRNO 04240135902780235564537405,-267,-31643.00
2017-08-28,PRZELEW UZNANIOWY (NADANO 28-08-2017) SK£ADKA CZ£ONKOWSKA ZA MIESI¥C 08-2017  BARTUŒ CZARNOWSKI  WOJSKA CZESKIEGO 43 BRNO 19693426894894862009992623,32,-31675.00
2017-08-28,PRZELEW UZNANIOWY (NADANO 28-08-2017) SK£ADKA CZ£ONKOWSKA ZA MIESI¥C 08-2017  MAREK TESTOWSKI  WOJSKA CZESKIEGO 43 BRNO 82984848858569633079336203,64,-31739.00
2017-08-30,PRZELEW UZNANIOWY (NADANO 30-08-2017) SK£ADKA CZ£ONKOWSKA ZA MIESI¥C 08-2017  PAWE£ NOWAK  WOJSKA CZESKIEGO 43 BRNO 24230845167923528518178274,32,-31771.00
2017-08-31,PRZELEW UZNANIOWY (NADANO 31-08-2017) SK£ADKA CZ£ONKOWSKA ZA MIESI¥C 08-2017  BARTUŒ NOWAK  WOJSKA CZESKIEGO 43 BRNO 05515562604895547889733191,16,-31787.00
2017-08-31,PRZELEW UZNANIOWY (NADANO 31-08-2017) SK£ADKA CZ£ONKOWSKA ZA MIESI¥C 08-2017  BARTUŒ NOWAK  WOJSKA CZESKIEGO 43 BRNO 34663224581407145630944284,128,-31915.00
2017-09-02,PRZELEW OBCI¥¯ENIOWY (NADANO 02-09-2017) COS DO PLACENIA  LOKAL  WOJSKA CZESKIEGO 43 BRNO 61879778176108775748473874,-387,-31528.00
2017-09-02,PRZELEW UZNANIOWY (NADANO 02-09-2017) SK£ADKA CZ£ONKOWSKA ZA MIESI¥C 09-2017  MAREK TESTOWSKI  WOJSKA CZESKIEGO 43 BRNO 62171430625332267726799829,64,-31592.00
2017-09-03,PRZELEW UZNANIOWY (NADANO 03-09-2017) SK£ADKA CZ£ONKOWSKA ZA MIESI¥C 09-2017  MICHA£ CZARNOWSKI  WOJSKA CZESKIEGO 43 BRNO 26067582514655473307883443,16,-31608.00
2017-09-03,PRZELEW UZNANIOWY (NADANO 03-09-2017) SK£ADKA CZ£ONKOWSKA ZA MIESI¥C 09-2017  £UKASZ NOWAK  WOJSKA CZESKIEGO 43 BRNO 98989305855796470723697488,16,-31624.00
2017-09-04,PRZELEW UZNANIOWY (NADANO 04-09-2017) SK£ADKA CZ£ONKOWSKA ZA MIESI¥C 09-2017  STANIS£AW CZARNOWSKI  WOJSKA CZESKIEGO 43 BRNO 65348748725835956438915377,32,-31656.00
2017-09-06,PRZELEW UZNANIOWY (NADANO 06-09-2017) DAROWIZNA  BARTUŒ CZARNOWSKI  WOJSKA CZESKIEGO 43 BRNO 99271115202196426511005724,952,-32608.00
2017-09-07,PRZELEW UZNANIOWY (NADANO 07-09-2017) SK£ADKA CZ£ONKOWSKA ZA MIESI¥C 09-2017  STANIS£AW CZARNOWSKI  WOJSKA CZESKIEGO 43 BRNO 65232666478172031514881482,64,-32672.00
2017-09-08,PRZELEW UZNANIOWY (NADANO 08-09-2017) SK£ADKA CZ£ONKOWSKA ZA MIESI¥C 09-2017  STANIS£AW OWCZAREK  WOJSKA CZESKIEGO 43 BRNO 38044287643821580240492872,128,-32800.00
2017-09-10,PRZELEW UZNANIOWY (NADANO 10-09-2017) SK£ADKA CZ£ONKOWSKA ZA MIESI¥C 09-2017  BARTUŒ CZARNOWSKI  WOJSKA CZESKIEGO 43 BRNO 29315893984860200241663316,16,-32816.00
2017-09-10,PRZELEW UZNANIOWY (NADANO 10-09-2017) SK£ADKA CZ£ONKOWSKA ZA MIESI¥C 09-2017  MICHA£ WARSZAWSKI  WOJSKA CZESKIEGO 43 BRNO 04837178036341481979573691,128,-32944.00
2017-09-12,PRZELEW UZNANIOWY (NADANO 12-09-2017) SK£ADKA CZ£ONKOWSKA ZA MIESI¥C 09-2017  DAWID RYBSKI  WOJSKA CZESKIEGO 43 BRNO 54460484407629590254996349,16,-32960.00
2017-09-12,PRZELEW OBCI¥¯ENIOWY (NADANO 12-09-2017) COS DO PLACENIA  UPC  WOJSKA CZESKIEGO 43 BRNO 36062544330168962669688232,-505,-32455.00
2017-09-13,PRZELEW UZNANIOWY (NADANO 13-09-2017) SK£ADKA CZ£ONKOWSKA ZA MIESI¥C 09-2017  HENRYK CHOLERAWIECKI  WOJSKA CZESKIEGO 43 BRNO 01348924800363831187955616,64,-32519.00
2017-09-14,PRZELEW UZNANIOWY (NADANO 14-09-2017) DAROWIZNA  BARTUŒ TESTOWSKI  WOJSKA CZESKIEGO 43 BRNO 34100367467433045416742311,889,-33408.00
2017-09-15,PRZELEW UZNANIOWY (NADANO 15-09-2017) SK£ADKA CZ£ONKOWSKA ZA MIESI¥C 09-2017  STANIS£AW CZARNOWSKI  WOJSKA CZESKIEGO 43 BRNO 73597738346847419523047914,128,-33536.00
2017-09-17,PRZELEW UZNANIOWY (NADANO 17-09-2017) SK£ADKA CZ£ONKOWSKA ZA MIESI¥C 09-2017  BARTUŒ CZARNOWSKI  WOJSKA CZESKIEGO 43 BRNO 42567192412909499683821642,32,-33568.00
2017-09-19,PRZELEW UZNANIOWY (NADANO 19-09-2017) SK£ADKA CZ£ONKOWSKA ZA MIESI¥C 09-2017  STANIS£AW CZARNOWSKI  WOJSKA CZESKIEGO 43 BRNO 95060749243779583923551997,16,-33584.00
2017-09-19,PRZELEW OBCI¥¯ENIOWY (NADANO 19-09-2017) COS DO PLACENIA  TAURON  WOJSKA CZESKIEGO 43 BRNO 47953624160853916154361162,-847,-32737.00
2017-09-19,PRZELEW UZNANIOWY (NADANO 19-09-2017) DAROWIZNA  DAREK NOWAK  WOJSKA CZESKIEGO 43 BRNO 47907944991842517796099704,420,-33157.00
2017-09-20,PRZELEW UZNANIOWY (NADANO 20-09-2017) DAROWIZNA  OKTAWIAN NOWAK  WOJSKA CZESKIEGO 43 BRNO 53594024580421752837160074,868,-34025.00
2017-09-22,PRZELEW UZNANIOWY (NADANO 22-09-2017) SK£ADKA CZ£ONKOWSKA ZA MIESI¥C 09-2017  BARTUŒ CZARNOWSKI  WOJSKA CZESKIEGO 43 BRNO 59753102224644902316343077,64,-34089.00
2017-09-24,PRZELEW UZNANIOWY (NADANO 24-09-2017) SK£ADKA CZ£ONKOWSKA ZA MIESI¥C 09-2017  PAWE£ NOWAK  WOJSKA CZESKIEGO 43 BRNO 37024386671334963838148094,64,-34153.00
2017-09-24,PRZELEW UZNANIOWY (NADANO 24-09-2017) SK£ADKA CZ£ONKOWSKA ZA MIESI¥C 09-2017  PAWE£ KOWALSKI  WOJSKA CZESKIEGO 43 BRNO 89601423017569151216900201,32,-34185.00
2017-09-26,PRZELEW UZNANIOWY (NADANO 26-09-2017) SK£ADKA CZ£ONKOWSKA ZA MIESI¥C 09-2017  MAREK NOWAK  WOJSKA CZESKIEGO 43 BRNO 88401465399062190660460185,128,-34313.00
2017-09-28,PRZELEW OBCI¥¯ENIOWY (NADANO 28-09-2017) COS DO PLACENIA  UPC  WOJSKA CZESKIEGO 43 BRNO 56581790577337070845572488,-875,-33438.00
2017-09-29,PRZELEW UZNANIOWY (NADANO 29-09-2017) SK£ADKA CZ£ONKOWSKA ZA MIESI¥C 09-2017  £UKASZ NOWAK  WOJSKA CZESKIEGO 43 BRNO 22773693352386443956184736,64,-33502.00
2017-09-30,PRZELEW UZNANIOWY (NADANO 30-09-2017) SK£ADKA CZ£ONKOWSKA ZA MIESI¥C 09-2017  BARTUŒ CZARNOWSKI  WOJSKA CZESKIEGO 43 BRNO 26901179583251307875331695,16,-33518.00
2017-09-30,PRZELEW OBCI¥¯ENIOWY (NADANO 30-09-2017) COS DO PLACENIA  LOKAL  WOJSKA CZESKIEGO 43 BRNO 60109042863099168023488352,-724,-32794.00
2017-10-01,PRZELEW UZNANIOWY (NADANO 01-10-2017) SK£ADKA CZ£ONKOWSKA ZA MIESI¥C 10-2017  OKTAWIAN PROSTACKI  WOJSKA CZESKIEGO 43 BRNO 42256423473191371360070339,32,-32826.00
2017-10-01,PRZELEW UZNANIOWY (NADANO 01-10-2017) SK£ADKA CZ£ONKOWSKA ZA MIESI¥C 10-2017  MICHA£ CZARNOWSKI  WOJSKA CZESKIEGO 43 BRNO 14126142988343083266786763,128,-32954.00
2017-10-02,PRZELEW UZNANIOWY (NADANO 02-10-2017) SK£ADKA CZ£ONKOWSKA ZA MIESI¥C 10-2017  DAWID RYBSKI  WOJSKA CZESKIEGO 43 BRNO 49885830266214908092407525,16,-32970.00
2017-10-03,PRZELEW UZNANIOWY (NADANO 03-10-2017) SK£ADKA CZ£ONKOWSKA ZA MIESI¥C 10-2017  HENRYK CHOLERAWIECKI  WOJSKA CZESKIEGO 43 BRNO 36050211551594340435072232,128,-33098.00
2017-10-04,PRZELEW UZNANIOWY (NADANO 04-10-2017) SK£ADKA CZ£ONKOWSKA ZA MIESI¥C 10-2017  OKTAWIAN PROSTACKI  WOJSKA CZESKIEGO 43 BRNO 26962266443237727969703007,64,-33162.00
2017-10-06,PRZELEW UZNANIOWY (NADANO 06-10-2017) DAROWIZNA  DAWID MARKOWSKI  WOJSKA CZESKIEGO 43 BRNO 91701234286653971655614328,769,-33931.00
2017-10-07,PRZELEW OBCI¥¯ENIOWY (NADANO 07-10-2017) COS DO PLACENIA  LOKAL  WOJSKA CZESKIEGO 43 BRNO 96236760454331733097473771,-306,-33625.00
2017-10-09,PRZELEW UZNANIOWY (NADANO 09-10-2017) SK£ADKA CZ£ONKOWSKA ZA MIESI¥C 10-2017  BARTUŒ NOWAK  WOJSKA CZESKIEGO 43 BRNO 46783957191556661424176684,32,-33657.00
2017-10-11,PRZELEW UZNANIOWY (NADANO 11-10-2017) SK£ADKA CZ£ONKOWSKA ZA MIESI¥C 10-2017  MICHA£ KOWALSKI  WOJSKA CZESKIEGO 43 BRNO 14036848984022331565503698,128,-33785.00
2017-10-11,PRZELEW UZNANIOWY (NADANO 11-10-2017) SK£ADKA CZ£ONKOWSKA ZA MIESI¥C 10-2017  STANIS£AW WARSZAWSKI  WOJSKA CZESKIEGO 43 BRNO 04910839871562713803444145,128,-33913.00
2017-10-13,PRZELEW UZNANIOWY (NADANO 13-10-2017) SK£ADKA CZ£ONKOWSKA ZA MIESI¥C 10-2017  STANIS£AW CZARNOWSKI  WOJSKA CZESKIEGO 43 BRNO 22573852581355111401027859,64,-33977.00
2017-10-15,PRZELEW UZNANIOWY (NADANO 15-10-2017) DAROWIZNA  MICHA£ KOWALSKI  WOJSKA CZESKIEGO 43 BRNO 28998019972357524766834311,480,-34457.00
2017-10-16,PRZELEW UZNANIOWY (NADANO 16-10-2017) SK£ADKA CZ£ONKOWSKA ZA MIESI¥C 10-2017  STANIS£AW WARSZAWSKI  WOJSKA CZESKIEGO 43 BRNO 80138887751586117932682602,16,-34473.00
2017-10-18,PRZELEW UZNANIOWY (NADANO 18-10-2017) SK£ADKA CZ£ONKOWSKA ZA MIESI¥C 10-2017  PAWE£ NOWAK  WOJSKA CZESKIEGO 43 BRNO 43171065345460756683046535,32,-34505.00
2017-10-19,PRZELEW UZNANIOWY (NADANO 19-10-2017) SK£ADKA CZ£ONKOWSKA ZA MIESI¥C 10-2017  MAREK TESTOWSKI  WOJSKA CZESKIEGO 43 BRNO 20355094009457676016795302,128,-34633.00
2017-10-20,PRZELEW UZNANIOWY (NADANO 20-10-2017) SK£ADKA CZ£ONKOWSKA ZA MIESI¥C 10-2017  £UKASZ STAROWSKI  WOJSKA CZESKIEGO 43 BRNO 16652262464578806182224033,32,-34665.00
2017-10-21,PRZELEW UZNANIOWY (NADANO 21-10-2017) SK£ADKA CZ£ONKOWSKA ZA MIESI¥C 10-2017  OKTAWIAN RYBSKI  WOJSKA CZESKIEGO 43 BRNO 01839990754695662184462579,64,-34729.00
2017-10-23,PRZELEW UZNANIOWY (NADANO 23-10-2017) SK£ADKA CZ£ONKOWSKA ZA MIESI¥C 10-2017  £UKASZ WARSZAWSKI  WOJSKA CZESKIEGO 43 BRNO 70524622980839708910779652,128,-34857.00
2017-10-25,PRZELEW UZNANIOWY (NADANO 25-10-2017) SK£ADKA CZ£ONKOWSKA ZA MIESI¥C 10-2017  £UKASZ WARSZAWSKI  WOJSKA CZESKIEGO 43 BRNO 90496748635174744515712006,32,-34889.00
2017-10-26,PRZELEW UZNANIOWY (NADANO 26-10-2017) SK£ADKA CZ£ONKOWSKA ZA MIESI¥C 10-2017  STANIS£AW WARSZAWSKI  WOJSKA CZESKIEGO 43 BRNO 87373365353761970287512788,32,-34921.00
2017-10-26,PRZELEW UZNANIOWY (NADANO 26-10-2017) SK£ADKA CZ£ONKOWSKA ZA MIESI¥C 10-2017  STANIS£AW OWCZAREK  WOJSKA CZESKIEGO 43 BRNO 04123519269607900880871432,16,-34937.00
2017-10-27,PRZELEW UZNANIOWY (NADANO 27-10-2017) SK£ADKA CZ£ONKOWSKA ZA MIESI¥C 10-2017  MAREK CZARNOWSKI  WOJSKA CZESKIEGO 43 BRNO 21882782962489553710243591,16,-34953.00
2017-10-28,PRZELEW UZNANIOWY (NADANO 28-10-2017) DAROWIZNA  HENRYK CHOLERAWIECKI  WOJSKA CZESKIEGO 43 BRNO 08287647494631862455355792,561,-35514.00
2017-10-28,PRZELEW UZNANIOWY (NADANO 28-10-2017) SK£ADKA CZ£ONKOWSKA ZA MIESI¥C 10-2017  BARTUŒ TESTOWSKI  WOJSKA CZESKIEGO 43 BRNO 87133901623238945401815316,64,-35578.00
2017-10-29,PRZELEW UZNANIOWY (NADANO 29-10-2017) SK£ADKA CZ£ONKOWSKA ZA MIESI¥C 10-2017  OKTAWIAN RYBSKI  WOJSKA CZESKIEGO 43 BRNO 80964202306999396875285969,16,-35594.00
2017-10-31,PRZELEW UZNANIOWY (NADANO 31-10-2017) SK£ADKA CZ£ONKOWSKA ZA MIESI¥C 10-2017  £UKASZ WARSZAWSKI  WOJSKA CZESKIEGO 43 BRNO 99706608707405011182638864,64,-35658.00
2017-10-31,PRZELEW UZNANIOWY (NADANO 31-10-2017) SK£ADKA CZ£ONKOWSKA ZA MIESI¥C 10-2017  MAREK TESTOWSKI  WOJSKA CZESKIEGO 43 BRNO 71414846705422373882908082,64,-35722.00
2017-11-01,PRZELEW UZNANIOWY (NADANO 01-11-2017) SK£ADKA CZ£ONKOWSKA ZA MIESI¥C 11-2017  DAREK NOWAK  WOJSKA CZESKIEGO 43 BRNO 71115132811513058284835542,32,-35754.00
2017-11-02,PRZELEW UZNANIOWY (NADANO 02-11-2017) SK£ADKA CZ£ONKOWSKA ZA MIESI¥C 11-2017  HENRYK KOWALSKI  WOJSKA CZESKIEGO 43 BRNO 89471160391334453701346829,16,-35770.00

